8,0,1,5;9,10,11,12,13,14,22,30,38,46,54;42,41,49,57,58,59,60,61,62,63,55,47,39,31,23,15,7,6,5,4,3,2,1,0,8,16;17,18,19,20,21,29,37,45,53,52,51,50;35,34,33,32,40,48,56;24,25,26,27,28,36,44,43
9,0,2,4;79,70,61,60,59,58,57,56,47,38,29,20,21,22,23,24,33;34,25,16,15,14,13,12,11,10,19,28,37,46,55,64,65,66,67,68,69,78;40,41,42,43,44,35,26,17,8,7,6,5,4,3,2,1,0,9,18,27,36,45,54,63,72,73,74,75,76,77;80,71,62,53,52,51,50,49,48,39,30,31,32
10,0,3,6;3,2,1,0,10,20,30,40,41,42,43,44,45;55,54,53,52,62,72,73,74,75,76,77,67,57,58,59,69,79,89,99,98,97,96,95,94,93,92,91,90,80,70,60,50;27,26,36,35,34,33,32;51,61,71,81,82,83,84,85,86,87,88,78,68;22,23,24,25,15,16,17,18,28,38,37,47,46,56,66,65,64,63;31,21,11,12,13,14,4,5,6,7,8,9,19,29,39,49,48
9,0,4,5;33,24,25,26,17,8,7,6,5,4,3,2,1,0,9,18,27,36,45,54,63,72;59,50,49,40,31,22,13,12,11,10;35,44,53,62,71,80,79,78,77,76,75,74,73,64,55,46,37,28,19,20,21,30,39,48,57,58;34,43,52,61,70,69,68,67,66,65,56,47,38,29;60,51,42,41,32,23,14,15,16
8,0,5,5;22,14,13,12,11,10,9,17,25,26,34,35,43,44;49,41,33,32,24,16,8,0,1,2,3,4,5,6,7,15,23;27,28,36,37,45,53,52,51,50,42;18,19,20,21,29,30,31,39,47,55,63;38,46,54,62,61,60,59,58,57,56,48,40
9,0,6,5;15,16,25,34,43,52,61,70,69,68,77,76,75,74,73,72,63,54,45,46,37,28,19,10;40,39,30,21,12,3,4,5,6,7,8,17,26,35,44,53,62,71,80,79,78;13,22,31,32,41,50,49,48,57,56,55;47,38,29,20,11,2,1,0,9,18,27,36;64,65,66,67,58,59,60,51,42,33,24,23,14
10,0,7,6;27,17,16,15,14,13,12,11,21,31,41,51,61,71,81,82,83,84,85,95,96,97,98,99;48,47,46,45,35,34,33;43,44,54,55,56,57,58,68;9,19,29,39,49,59,69,79,89,88,87,86,76,75,74,73,72,62,52,42,32,22,23,24,25,26,36,37;38,28,18,8,7,6,5,4,3,2,1,0,10,20,30,40,50,60,70,80,90,91,92,93,94;53,63,64,65,66,67,77,78
9,0,8,5;8,7,6,5,4,13,22,31,40;19,28,37,46,55,64,65,66,67,68,69,70,61,52;25,24,33,42,51,60,59,58,49,48,39,30,21,12,3,2,1,0;57,56,47,38,29,20,11,10,9,18,27,36,45,54,63,72,73,74,75,76,77,78,79,80,71,62,53,44,43,34;35,26,17,16,15,14,23,32,41,50
8,0,9,5;33,41,49,50,51,52,53,54;39,31,30,29,28,20,19,18;7,15,23,22,21,13,12,11,10,9,17,25;34,42,43,44,45,46,47,55,63,62,61,60,59,58,57,56,48,40,32,24,16,8,0,1,2,3,4,5,6,14;38,37,36,35,27,26
9,0,10,5;25,24,23,22,21,20,29,38,47,56,65,66,67,68,69,70;40,41,42,43,44,35,26,17,8,7,6,5,4,3,2,1,0,9,18,27,36,45,54,63,72;34,33,32,31,30,39,48,57,58,59,60,61;80,71,62,53,52,51,50,49;79,78,77,76,75,74,73,64,55,46,37,28,19,10,11,12,13,14,15,16
10,0,11,6;28,27,26,16,15,14,13,23,22,32,42,43,53,54;77,76,75,74,73,72,71,61,60,50,40,30,20,10,0,1,2,3,4,5,6,7,17,18;33,34,44,45,55,56,57,58,68,78,88,87,86,85,84,83,82,81,80,70;8,9,19,29,39,38,37,36,35,25,24;12,11,21,31,41,51,52,62,63,64,65,66,67;46,47,48,49,59,69,79,89,99,98,97,96,95,94,93,92,91,90
9,0,12,6;32,33,24,15,14,13,12,11,20,29,38;8,17,26,35,44,43,42,41,50;61,70,69,68,67,66,65,64,55,46,37,28,19,10;47,48,39,30,21,22,23;34,25,16,7,6,5,4,3,2,1,0,9,18,27,36,45,54,63,72,73,74,75,76,77,78,79,80,71,62,53,52,51,60,59;56,57,58,49,40,31
8,0,13,5;13,14,22,30,38,46,45,44,43,42,34;63,62,61,60,52,51,50,49,41,33,25,17;53,54,55,47,39,31,23,15,7,6,5,4,12,20,21,29,37,36,35;28,27,19,11,3,2,1,0;26,18,10,9,8,16,24,32,40,48,56,57,58,59
9,0,14,5;74,75,66,57,48,39,40,41;56,47,38,29,30,31,32,33,42,51,60,59;0,1,2,3,4,5,6,7,8,17,26,35,44,53,62,71,80,79,78,77,76,67,58,49,50;24,23,22,21,20,19,28,37,46,55,64,65;68,69,70,61,52,43,34,25,16,15,14,13,12,11,10,9,18,27,36,45,54,63,72,73
10,0,15,5;90,91,92,93,94,95,96,86,87,77,67,57,47,37,27,26,25,24,34,44,45,55,65;97,98,88,78,68,58,48,38,28,18,17,16,15,14,13,23,33,43,53,63,73,72,71,61,51,41,31,21,11,1,0;35,36,46,56,66,76,75,85;54,64,74,84,83,82,81,80,70,60,50,40,30,20,10;62,52,42,32,22,12,2,3,4,5,6,7,8,9,19,29,39,49,59,69,79,89,99
9,0,16,4;19,20,29,38,47,56,57,58,59,60,51,42,33,24,23,14,5,6,7,8,17,26,35,44,53,62,71,80,79,78,77,76,75,74,73,72,63,54,45,36;15,16,25,34,43,52,61,70,69,68,67,66,65,64,55,46,37,28,27;48,49,50,41,32,31,22,13,4,3,2,1,0;18,9,10,11,12,21,30,39,40
8,0,17,5;50,49,41,33,25,17,9,10,11,12,13,14;38,30,22,21,20,19,18,26;54,46,45,37,29,28,27,35;36,44,52,53,61,62,63,55,47,39,31,23,15,7,6,5,4,3,2,1,0,8,16,24,32,40,48,56,57,58;34,42,43,51,59,60
9,0,18,4;28,19,10,11,12,13,14,15,16,25,34,43,52,61,70,69,68,67,66,65;74,75,76,77,78,79,80,71,62,53,44,35,26,17,8,7,6,5,4,3,2,1,0,9,18,27,36,37,38,29,30,31,32,41,50,49,58,57,56,55,64;20,21,22,23,24,33,42,51,60,59;73,72,63,54,45,46,47,48,39,40
10,0,19,6;46,36,37,38,28,18,17,16,15,14,13,12,11,21,31,41,51,61,71;99,98,97,96,95,94,84,74,64,54,44,45;78,77,76,66,56,57,47;27,26,25,35,34,33,43,53,63,73,83,93,92,91,90;59,69,79,89,88,87,86,85,75,65,55;24,23,22,32,42,52,62,72,82,81,80,70,60,50,40,30,20,10,0,1,2,3,4,5,6,7,8,9,19,29,39,49,48,58,68,67
9,0,20,6;0,9,18,27,36,37,38,29,30,31,32;45,46,47,48,39,40,41,50;59,60,51,42,33,24,23,22,21;64,65,66,67,68,69,70,61,52,43,34,25,16,15;20,11,12,13,14,5,6,7,8,17,26,35,44,53,62,71,80,79,78,77,76,75,74,73,72,63,54,55,56,57,58,49;28,19,10,1,2,3,4
8,0,21,5;21,29,30,38,46,54,62,61;16,24,32,40,48,56,57,58,59,60,52,53,45,37;15,7,6,5,4,3,11,19,27,35,43,51,50,49,41,33,25,17,9,8;44,36,28,20,12,13,14,22,23,31,39,47,55,63;0,1,2,10,18,26,34,42
9,0,22,4;59,58,67,66,65,64,55,46,37,28,19,10,11,12,13,14,15,16;40,41,42,43,52,61,70,79,78;77,68,69,60,51,50,49,48,39,30,31,32,33,34,35,44,53,62,71,80;76,75,74,73,72,63,54,45,36,27,18,9,0,1,2,3,4,5,6,7,8,17,26,25,24,23,22,21,20,29,38,47,56,57
10,0,23,6;52,42,43,33,34,35,36,37,47,48;32,22,23,24,25,26,27,28,29,19,9,8,7,6,5,4,3,2,1,0,10,20,30,40,50,60,70,71,81;18,17,16,15,14,13,12,11,21,31,41,51,61,62,72,82,83,84,85,86,87,88;44,45,46,56,57,58,59,49,39,38;64,65,66,67,68,69,79,89,99,98,97,96,95,94,93,92,91,90,80;55,54,53,63,73,74,75,76,77,78
9,0,24,4;66,65,56,47,38,29,20,21,22,23,24,33;71,70,61,52,43,34,25,16,15,14,13,12,11,10,19,28,37,46,55,64;62,53,44,35,26,17,8,7,6,5,4,3,2,1,0,9,18,27,36,45,54,63,72,73,74,75,76,67,58,57,48,39,30,31,32,41,42,51,60,69,78,79,80;40,49,50,59,68,77
8,0,25,4;49,41,33,25,26,27,28;52,53,54,46,38,30,22,14,13,12,11,10,2;1,9,17,18,19,20,21,29,37,45,44,43,51,59,60,61,62,63,55,47,39,31,23,15,7,6,5,4,3;0,8,16,24,32,40,48,56,57,58,50,42,34,35,36
9,0,26,6;20,29,38,37,36,45,54,63,72,73,74,75,76,77,78,79,80,71;39,40,31,22,13,4,3,2,1,0,9,18;46,55,56,57,58,59,60,51,52,43,34,25;27,28,19,10,11,12,21,30;32,23,14,5,6,7,8,17,26,35,44,53,62,61,70,69,68,67,66,65,64;47,48,49,50,41,42,33,24,15,16
10,0,27,5;54,55,45,35,34,24,23,22,21,20,10,0,1,2,3,4,5,6,7,8,9,19,29,39,49,59,69,79,89,99,98,97,96,95,94,93,92,91,90,80,70,60,50;27,37,47,57,67,77,76,75,74,73,72,62;25,26,36,46,56,66,65,64,63,53,52,42,41;11,12,13,14,15,16,17,18,28,38,48,58,68,78,88,87,86,85,84,83,82,81,71,61,51;40,30,31,32,33,43,44
9,0,28,5;46,37,28,19,18,9,0,1,2,3,4,5,6,7,8,17,26,35,44,53,62,71,80,79,78,77,76,75,74,73,72;27,36,45,54,55,56,57,58,59,60,51,42,33,24,23,22;10,11,20,29,30,39,40;63,64,65,66,67,68,69,70,61,52,43,34,25,16,15,14,13,12,21;38,47,48,49,50,41,32,31
8,0,29,5;42,50,51,52,53,54,46,38,30,22,14;8,16,17,18,26,34,33,41,49;45,37,29,21,13,5,6,7,15,23,31,39,47,55,63,62,61,60,59,58,57,56,48,40,32,24,25;2,3,4,12,20,28,36,44,43;35,27,19,11,10,9,1,0
9,0,30,4;0,1,2,3,4,5,6,7,16,25,34,43,42,41,40,39,38,47,56,57,58,59,60,61,62;80,79,78,77,76,75,74,73,72,63,54,45,36,27,18,19,20,21,22,23;48,49,50,51,52,53,44,35,26,17,8;9,10,11,12,13,14,15,24,33,32,31,30,29,28,37,46,55,64,65,66,67,68,69,70,71
