5,0,1,5;0,5,10,15,20,21;2,1,6,11,16;7,12,17,22;4,3,8,13,18;9,14,19,24,23
5,0,2,4;17,22,21,20;12,11,16;24,23,18,13,8,7,6,5,10,15;19,14,9,4,3,2,1,0
5,0,3,5;8,13,12;3,4,9,14,19,24,23;20,21,16,11,6,7,2;15,10,5,0,1;18,17,22
5,0,4,4;3,2,1,0,5;4,9,8,7,6,11,10,15,20;21,16,17,18;22,23,24,19,14,13,12
5,0,5,4;3,2,1,0,5,10,15,20,21,22;4,9,8;19,14,13,12,7;6,11,16,17,18,23,24
5,0,6,4;19,18,17,12,7,8,3;4,9,14,13;2,1,6,11,16;0,5,10,15,20,21,22,23,24
5,0,7,4;18,17,16;12,11,6,5;0,1,2,7,8,13;3,4,9,14,19,24,23,22,21,20,15,10
5,0,8,5;16,11,6,1,2,3;19,24,23,22;0,5,10,15,20,21;12,7,8;17,18,13,14,9,4
5,0,9,4;22,23,24,19,14,9,4,3;8,13,18,17,16,21;7,2,1,0,5,10,15,20;6,11,12
5,0,10,4;11,6,7,8;5,0,1,2,3,4,9,14,19,24;12,17,16,15,10;20,21,22,23,18,13
5,0,11,4;24,19,14,9,4,3,2;12,17,16,15,20;0,5,10,11;21,22,23,18,13,8,7,6,1
5,0,12,5;3,2,1,0,5,10;4,9,8;16,11,6,7;24,23,18;15,20,21,22,17,12,13,14,19
5,0,13,5;10,15,20,21,22,23;18,17,16,11,6,5,0;13,14,19,24;3,2,1;12,7,8,9,4
5,0,14,5;24,23,18;2,1,0,5,10;19,14,9,4;3,8,7,6,11,16,15,20;21,22,17,12,13
5,0,15,4;20,15,10;7,8,13,18,17,16,21;12,11,6,5,0;1,2,3,4,9,14,19,24,23,22
5,0,16,4;17,18,19;8,7,6;10,15,20,21,22,23,24;5,0,1,2,3,4,9,14,13,12,11,16
5,0,17,4;0,1,2,3,4;7,12,11,16;8,13,18,17,22,21,20,15,10,5,6;9,14,19,24,23
5,0,18,4;20,15,10,5,0,1,2,3,4,9,14,13,18,17;19,24,23,22;12,7,8;21,16,11,6
5,0,19,4;5,0,1,2,3,4,9,14,19,24,23,22;15,10,11,12,13;6,7,8;18,17,16,21,20
5,0,20,4;17,16,11,6,1,0;12,7,2;4,9,14,19,24,23,22,21,20,15,10,5;3,8,13,18
5,0,21,5;7,8,13,18;6,11,12,17,22;20,21,16;9,4,3,2,1,0,5,10,15;23,24,19,14
5,0,22,5;10,5,0,1;24,23,22,21;12,13,8;20,15,16,11;6,7,2,3,4,9,14,19,18,17
5,0,23,4;10,15,20,21,22,17,18;8,7,6;5,0,1,2,3,4,9,14,13,12,11,16;23,24,19
5,0,24,4;0,1,2,3,4;21,20,15,10,5,6,7,8,9,14;24,23,22,17,16,11;12,13,18,19
5,0,25,5;4,3,2,1;0,5,6,7,8,9,14;18,17,16,21,20;19,24,23,22;15,10,11,12,13
5,0,26,4;6,7,8;24,23,22,17;15,10,5,0,1,2,3,4,9,14;20,21,16,11,12,13,18,19
5,0,27,4;6,7,8,3,4;24,23,22,21,20,15,10,5,0,1,2;13,12,11;9,14,19,18,17,16
5,0,28,5;6,7,8;18,17,22,21;23,24,19,14,13,12,11,16;20,15,10;5,0,1,2,3,4,9
5,0,29,5;6,7,8;0,1,2,3,4,9,14;18,17,16,15;19,24,23,22,21,20;5,10,11,12,13
5,0,30,4;11,16,21;20,15,10,5,6,7,12;17,18,13,8,3,2,1,0;22,23,24,19,14,9,4
6,0,1,6;4,3,9,15,21,20;0,6,12,18,24;32,33,34,35,29,23,17,11,5;1,7,13,19,25,31,30;26,27,28,22,16,10;2,8,14
6,0,2,6;25,19,13,7,8,9,15;17,11,5;2,3,4,10,16,22,23;26,20,14;1,0,6,12,18,24,30,31,32,33,34,35,29;21,27,28
6,0,3,4;15,9,3,4,5,11,17,23,29,35,34,33;10,16,22,28;32,31,30,24,18,12,6,0,1,2,8,14,20,21,27;26,25,19,13,7
6,0,4,4;27,28,22,16,10,9,8,7,6,12,18;21,15,14,13,19;25,26,20;24,30,31,32,33,34,35,29,23,17,11,5,4,3,2,1,0
6,0,5,4;15,14,13,19,18,24,30,31,32,33,27,28;34,35,29,23,17,11,5,4,3,2,1,0;25,26,20,21,22;16,10,9,8,7,6,12
6,0,6,6;3,4,10,16;5,11,17;20,14,8,2,1,0,6,12,18,24,30;9,15,21;23,29,35,34,33,32,31,25,19,13,7;22,28,27,26
6,0,7,5;24,30,31,32,33,34,35,29,23,17;28,22,16,10,9,8;2,1,0,6,12,18,19,25,26,27,21,15;11,5,4,3;7,13,14,20
6,0,8,5;8,7,13,19,25;21,27,33,34,35,29,23,17,11,5;4,10,16,22,28;20,26,32;31,30,24,18,12,6,0,1,2,3,9,15,14
6,0,9,6;17,16,15,14,13,7,6,0;1,2,3,4,5;29,28,27,26,25;23,22,21,20,19;35,34,33,32,31,30,24,18,12;8,9,10,11
6,0,10,5;11,5,4,3,2,1,0;20,21,27,33,34,35,29,23,17;28,22,16,10;25,19,13,14,15;9,8,7,6,12,18,24,30,31,32,26
6,0,11,5;22,21,20,19,18,12,6,0,1,2,3,4,5,11;24,30,31,32,33,34,35,29,23;7,13,14,15,16,17;28,27,26,25;10,9,8
6,0,12,4;8,9,10,16,22,28,27,26,25,24,30;1,0,6,12,18,19,20,21;7,13,14,15;31,32,33,34,35,29,23,17,11,5,4,3,2
6,0,13,5;8,9,3,4,5,11,17;28,27,21,15,14,13,7;2,1,0,6,12;24,18,19,20,26,32,33,34,35,29,23,22,16,10;30,31,25
6,0,14,5;33,27,21;8,7,13,19,25,31;10,16,22,28,34,35;30,24,18,12,6,0,1,2,3,9,15,14,20,26,32;29,23,17,11,5,4
6,0,15,6;12,18,24,30;15,21,22,28;6,7,13;33,34,35,29,23,17,11,5,4,3,2,1,0;32,26,27;31,25,19,20,14,8,9,10,16
6,0,16,6;25,26,27,21;15,14,20,19;30,31,32,33,34,35,29,23,17,11,5,4,3;10,9,8,7,13,12,18,24;28,22,16;2,1,0,6
6,0,17,6;5,4,3,2,8,7;24,30,31,32,33,27,21,15;34,35,29,23,17,11,10,9;1,0,6,12,18,19,25,26;28,22,16;13,14,20
6,0,18,5;15,14,13;7,8,9,10,16,22,21,20,19,25,31,32;28,27,26;11,17,23,29,35,34,33;30,24,18,12,6,0,1,2,3,4,5
6,0,19,5;11,10,9,15;0,6,12,18,24,30,31,32,33,34,35,29,23,17,16;5,4,3,2,8,14;28,27,26,25;22,21,20,19,13,7,1
6,0,20,4;27,28,22;21,15,14,13,19,25;0,1,2,3,4,5,11,17,23,29,35,34,33;16,10,9,8,7,6,12,18,24,30,31,32,26,20
6,0,21,6;13,14,8,2,1;5,11,17,23,29,35,34,33,32,31;0,6,7;21,20,19,18,12;15,9,3;4,10,16,22,28,27,26,25,24,30
6,0,22,5;5,11,17,23,29,35,34,33,32,31,30,24;13,14,20;27,28,22,16,10,4,3,2,1,0;6,7,8,9,15,21;12,18,19,25,26
6,0,23,4;20,21,22,23,17;5,4,3,2,1,0,6,12,18,24,30,31,32,33,34,35;29,28,27,26,25,19,13,7,8,9,10,11;14,15,16
6,0,24,6;2,3,4,10,16,22,21,27;8,7,1,0;25,26,20;28,34,33,32,31,30,24,18,19;9,15,14,13,12,6;5,11,17,23,29,35
6,0,25,6;31,25,19,13,7,8,9,10,11;1,0,6,12,18,24,30;15,16,17;21,27,28;5,4,3,2;22,23,29,35,34,33,32,26,20,14
6,0,26,5;33,34,35,29,23,17,11,5,4,3,2,1,0;6,7,8,9,10,16,22,28,27;30,24,25,19,20,21;31,32,26;15,14,13,12,18
6,0,27,5;28,22,21,15,9,10;33,27,26,20,14,8,2,3,4,5,11;16,17,23,29,35,34;32,31,30,24,18,12,6;25,19,13,7,1,0
6,0,28,4;31,32,33,34,35,29,23,17,11,5,4,3,2,1;25,26,27,28;30,24,18,19,20,21,22,16,10,9,8,7;0,6,12,13,14,15
6,0,29,6;12,13,7;15,21,27,26,32,31,30,24,18;6,0,1,2,3,4,5,11,17,23;25,19,20,14,8;9,10,16,22,28;29,35,34,33
6,0,30,5;6,0,1,2,3,4,5,11,17,23;9,10,16,22,28;29,35,34,33,27,21,15,14,8,7;25,24,18,12,13;30,31,32,26,20,19
7,0,1,6;13,20,19,18,17,16,23,22,29,36,37,38,39;30,31,24;47,46,45,44,43,42,35,28,21,14,7,0,1,2,3,4,5,6;32,33,40;12,11,10,9,8,15;48,41,34,27,26,25
7,0,2,7;2,3,4,5,6,13,20,27,34,41,48,47,46,45;26,19,18,17,16;10,11,12;32,25,24;37,36,29,22,15,8,9;33,40,39,38,31,30,23;44,43,42,35,28,21,14,7,0,1
7,0,3,8;23,30,37,38,39,40,41,34;27,26,25,18;28,35,42,43,44,45,46,47,48;20,19,12,11,10,9,8,7;33,32,31,24,17;0,1,2,3,4,5,6,13;16,15,14;21,22,29,36
7,0,4,5;40,33,26,19,12,11,10,9,8,15,14,21,28,35;7,0,1,2,3,4,5,6,13,20,27,34,41,48,47,46,45,44,43,42;36,29,22,23,24,31,32;25,18,17,16;39,38,37,30
7,0,5,6;30,23,16,15;32,33,26,19,12;25,18,11,10,9,8,1;2,3,4,5,6,13,20,27,34,41,40,39,38,31,24,17;48,47,46,45,44,37,36,29,22;43,42,35,28,21,14,7,0
7,0,6,7;10,9,8;12,11,18;27,34,41;23,22,29,36,37,38,39;48,47,40,33,32,31,30;17,24,25,26,19,20,13,6,5,4,3,2,1,0,7;16,15,14,21,28,35,42,43,44,45,46
7,0,7,5;12,11,10,9,8;15,16,17,18,19,20,13,6,5,4,3,2,1,0,7;22,23,24;29,36,37,38,39,40,33;14,21,28,35,42,43,44,45,46,47,48,41,34,27,26,25,32,31,30
7,0,8,7;27,26,25,24;4,3,2,1,0,7,14,21,28,35,42,43,44,45,46,47;31,32,33,34;23,30,37;13,20,19,18,17,16,15,22,29,36;6,5,12,11,10,9,8;38,39,40,41,48
7,0,9,6;6,13,12,11,10,17,24,25,26,27;9,16,23,30,31,32,33;20,19,18;40,39,38,37,36,29,22;5,4,3,2,1,0,7;34,41,48,47,46,45,44,43,42,35,28,21,14,15,8
7,0,10,6;24,17,10,11,12,19,26,33,40;37,30,23,16,9,2,3,4,5,6,13,20,27,34,41,48,47;18,25,32,39,46;45,38,31;44,43,36,29,22,15,8;42,35,28,21,14,7,0,1
7,0,11,7;12,19,26,33,40;36,37,38;17,10,3,2,1,0,7;25,18,11,4,5,6,13,20,27,34,41,48,47,46,45,44,43,42,35;22,29,30,31,32,39;24,23,16,9;8,15,14,21,28
7,0,12,7;12,11,10,9,8,15;14,7,0,1,2,3,4,5,6,13,20,19,18,17;44,45,46,47,40;31,24,25,26,27;16,23,30,37,38,39,32,33,34,41,48;21,28,35,42;22,29,36,43
7,0,13,6;12,19,26,25,32,31,30,23,16,15,8;41,48,47,46,45,44,43,42,35,28;11,10,9;5,4,3,2,1,0,7,14,21,22,29,36,37,38,39,40,33,34;27,20,13,6;24,17,18
7,0,14,8;10,3,4,5,6,13,20;31,24,17,16;29,30,23;33,40,47,46,45;22,15,8;11,18,25,32,39,38,37,44,43,42;48,41,34,27,26,19,12;9,2,1,0,7,14,21,28,35,36
7,0,15,5;0,1,2,3,4,11,18,25;28,35,42,43,44,45,46,47,48,41,34,27,20,13,6;32,31,24,17,10,9,8,15;5,12,19,26,33,40,39,38,37,36,29,22,21,14,7;16,23,30
7,0,16,5;47,48,41,34,33,32,31,30,29;8,9,10,11,12,19,26,25,24,23,22,21,28,35,36,37,38;7,0,1,2,3,4,5,6,13,20,27;18,17,16,15,14;42,43,44,45,46,39,40
7,0,17,7;33,34,27,20,13,6;41,48,47,46,45,38,37,36;15,16,17,24,25;40,39,32,31,30,23;26,19,12,5,4,3,2,1,0,7,14,21,22;44,43,42,35,28,29;8,9,10,11,18
7,0,18,7;20,13,6,5,4,3,2,1,0,7,14,21,28,29,36;8,15,22,23,30,37;38,31,24,17,18,19;12,11,10,9,16;47,40,33;48,41,34;27,26,25,32,39,46,45,44,43,42,35
7,0,19,6;43,36,29,22,15,8,9,10,11,4,5,6,13,20,27;26,25,24,31;48,41,34;3,2,1,0,7,14,21,28,35,42;40,47,46,45,44;33,32,39,38,37,30,23,16,17,18,19,12
7,0,20,5;3,4,5,6,13,20,27,34,41,48,47,46,45,44,43,42,35,28,21,14,7,8,9;0,1,2;15,16,17,24;18,25,32,31,30,23,22;10,11,12,19,26,33,40,39,38,37,36,29
7,0,21,6;12,19,26,33,40,39,38,37;24,23,16,9,8,7;0,1,2,3,10,11;14,15,22;4,5,6,13,20,27,34,41,48,47,46,45,44,43,36,29,30,31,32,25,18,17;42,35,28,21
7,0,22,7;0,1,2,3,10;14,7,8,9;11,4,5,6,13,20,27,26,25,24,23;40,39,38,37;42,43,44,45,46,47,48,41,34;33,32,31,30,29,36;35,28,21,22,15,16,17,18,19,12
7,0,23,6;38,37,36,29,22,15,8,1,2,3,4;0,7,14,21,28,35,42,43,44,45,46,39,32;47,40,33;25,26,27,34,41,48;13,20,19,18,17,24;6,5,12,11,10,9,16,23,30,31
7,0,24,6;42,43,44,45;13,20,19,18,17,16,23,30,29;39,46,47,48;34,27,26,25,24;14,7,0,1,2,3,4,5,6;12,11,10,9,8,15,22,21,28,35,36,37,38,31,32,33,40,41
7,0,25,6;12,5,4,3,2,1;0,7,14,21,28,35,42,43,44,45;47,48,41,34,27,26,25,24,17,16,15;8,9,10,11,18,19,20,13,6;40,33,32,31,30,23,22;29,36,37,38,39,46
7,0,26,5;16,17,24,31,38;29,28,21,14,7,0,1;42,43,44,45,46,47,48,41,34,27,20,13,6,5,4,3,2;35,36,37,30,23,22,15,8,9,10,11,18,25,32,39,40;33,26,19,12
7,0,27,5;4,5,6,13,20,27,34,41,40,39,38,37,36,29,22;12,19,26,33;48,47,46,45,44,43,42,35,28,21,14,7,0,1,2,3;16,23,30,31,32,25,18,11;15,8,9,10,17,24
7,0,28,7;24,31,32,33,26,19,12;2,3,4,11,18,25;43,44,45,46,47,48,41,34,27,20,13,6,5;17,16,15,14,7;42,35,36,29;28,21,22,23,30,37,38,39,40;0,1,8,9,10
7,0,29,6;33,26,19,12,11,10,9,8,15;35,42,43,44,37,30,31;18,17,16;39,40,41,34,27,20,13,6,5,4,3,2,1,0,7,14,21,28,29,36;38,45,46,47,48;22,23,24,25,32
7,0,30,7;40,39,38,37,36,29;2,3,4;27,20,13,6,5;7,14,21,22,23,30;0,1,8,15,16,17,24,31,32,33,34,41,48,47,46,45,44,43,42,35,28;12,19,26,25;9,10,11,18
8,0,1,6;4,3,2,1,0,8,16,24,32,40,48,56,57;20,19,18,26,34,42,43,51,52,53,54,46,38,30,22,14;44,45,37,29,28;21,13,5,6,7,15;36,35,27;12,11,10,9,17,25,33,41,49,50,58,59,60,61,62,63,55,47,39,31,23
8,0,2,6;0,8,16,17,18,19,20,28,36,44,43,42,41,49,48,56;27,35,34,33,32,40;45,37,29,21,13,12,11,10,9,1;26,25,24;57,58,50,51,52,53,54,46,38,30,22,14;59,60,61,62,63,55,47,39,31,23,15,7,6,5,4,3,2
8,0,3,6;35,34,33,32,24,16,8,0,1;63,55,54,53,45,37,29,28,27,26,25,17,9,10,2,3,4,5,6,7,15,23,31,39;47,46,38,30,22,21,20,19,18;14,13,12,11;62,61,60,59,58,57,56,48,40,41,42,43;36,44,52,51,50,49
8,0,4,7;50,49,41,33,34,35,36;15,7,6,5,4,3,2,1,9,17,25;51,52,53,54,46,47;0,8,16,24,32,40,48,56,57,58,59,60,61,62,63,55;39,38,37,45,44,43,42;14,13,12,11,10,18,26,27,28,29,30;31,23,22,21,20,19
8,0,5,6;50,51,52,53,54,46,38;29,28,36,35,34,33,32,40,48,56;39,31,30,22,21,20,19,18,17,9;47,55,63,62,61,60,59,58,57,49,41,42,43,44,45,37;23,15,14,13,12,11,10;7,6,5,4,3,2,1,0,8,16,24,25,26,27
8,0,6,7;0,1,2,10,18,26,27,28,29,37,45,46,47;49,41,42,43,51,52,53,54,55,63;7,6,5,4,3,11,19,20,21,22,30,38;57,56,48,40,32,24,16;39,31,23,15,14,13,12;50,58,59,60,61,62;44,36,35,34,33,25,17,9,8
8,0,7,5;45,46,54,62,61,60,59,58,57,56,48,40,32,24,16,8,0,1,2,3,4,12;18,26,34,42;13,5,6,7,15,23,31,30,29,28,27,35,43,44;53,52,51,50,49,41,33,25,17,9,10,11,19,20,21,22,14;36,37,38,39,47,55,63
8,0,8,7;63,62,61,53,45,44;7,15,23,22,21,20,19,18,26,25,33,41;42,34,35,27,28,29,30,31,39,47;36,37,38,46,54,55;17,9,10,11,12,13,14,6;52,60,59,58,57,56,48,40,32,24,16,8,0,1,2,3,4,5;49,50,51,43
8,0,9,6;53,52,44,43,42,34,26,18,19,11,12,13,14,15;28,20,21,22,23;1,0,8,16,24,32,40,48,56,57,58;31,30,29;54,46,45,37,36,35,27;7,6,5,4,3,2,10,9,17,25,33,41,49,50,51,59,60,61,62,63,55,47,39,38
8,0,10,6;30,38,46,45,44,43;28,20,21,22,23,15,7,6,5,4,3,2,1,0,8,16,24,32,40,48,56;29,37,36,35,27,19,18;50,42,34,26,25,17,9,10,11,12,13,14;33,41,49,57,58,59,60,61,62,63,55,47,39,31;54,53,52,51
8,0,11,7;34,42,43,44,52;35,36,37,45,53,54;39,47,55,63,62,61,60,59,51,50,49,41,33,25,26,27,28,29,21,22;1,9,10,11,12,13,14;17,18,19,20;0,8,16,24,32,40,48,56,57,58;46,38,30,31,23,15,7,6,5,4,3,2
8,0,12,6;20,19,27,35,43,44,45,37;4,5,13,14,22,30,38,46,54,53,52,51,50,42,34,26,18,10,9;17,25,33,41,49;6,7,15,23,31,39,47,55,63,62,61,60,59,58,57,56,48;36,28,29,21;40,32,24,16,8,0,1,2,3,11,12
8,0,13,6;1,2,10,18,26,34,35,36,28,20,12,4,5,6;0,8,9;16,24,32,40,48,56,57,58,59,60,61,62,63,55,47,39,31,23,15,7;42,43,44,45,37,29,21,13,14;17,25,33,41,49,50,51,52,53,54,46,38,30,22;3,11,19,27
8,0,14,6;42,34,26,18,19,20,21,22,30,38,46,54;62,61,53,52,51,50,49,41,33,25,17,9,10,11,12,13,14;29,37,36;60,59,58,57,56,48,40,32,24,16,8,0,1,2,3,4,5,6,7;45,44,43,35,27,28;15,23,31,39,47,55,63
8,0,15,6;63,62,61,60,52,51,43,42,34,26,18,19,11,12,13,14,22,30;1,0,8,16,24,32,40,48,56,57,58,59;21,29,37,38,39,31,23,15,7,6,5,4,3,2,10,9,17,25,33,41,49,50;20,28,27,35;47,46,45,44,36;55,54,53
8,0,16,7;42,34,26;7,15,23,31,39,47,55,63,62,61,53,45,37,29,21,13,5,4,3,2,1,0;51,43,35,27,28;36,44,52,60,59,58,57,56,48,40;32,24,16,8,9,10,11,12;20,19,18,17,25,33,41,49,50;6,14,22,30,38,46,54
8,0,17,8;36,35,34,33,41,49;60,61,53,54,46;62,63,55,47,39,31,23,15,7,6,5,4,3,2,1,0;43,42,50;38,30,22,14,13,12,11,10,9,8,16,24;32,40,48,56,57,58,59,51,52,44;17,18,19,20,21,29,37,45;28,27,26,25
8,0,18,9;13,5,6,7,15;23,31,39,47,55,63;8,9,10,18;21,22,14;44,36,28,20,12,4;0,1,2,3,11,19,27,26,25,17,16;42,43,35;34,33,41,49,50,51,52,53,45,37,29;30,38,46,54,62,61,60,59,58,57,56,48,40,32,24
8,0,19,8;12,11,19,18,17;54,53,52,51,50,49;38,39,47,55,63,62,61,60,59,58,57,56,48,40,41,42,43,44,36,28;46,45,37;20,21,29,30,31,23,15,7,6;26,25,24,16,8,0,1;27,35,34,33,32;9,10,2,3,4,5,13,14,22
8,0,20,9;4,3,11,19,20,21,22,30,31;59,58,57,56,48,40,32,24;45,44,43,51;29,28,27,26,18,10,9;49,41,33,25,17,16,8,0,1,2;39,47,55,63,62,61;12,13,14;50,42,34,35,36,37,38,46,54,53,52,60;23,15,7,6,5
8,0,21,8;49,41,42,34,35,27;17,9,10,11,12,13,21,29,30,38,46,47,55,63,62,61;7,15,23,31,39;33,25,26,18,19,20,28,36,44,52,60,59;6,14,22;37,45,53,54;43,51,50,58;57,56,48,40,32,24,16,8,0,1,2,3,4,5
8,0,22,6;14,22,30,38,46,45,44,36,28;54,53,52,51,43,35,27,19;18,26,34,42,50,58,59,60,61,62,63,55,47,39,31,23,15,7,6;57,56,48,40,32,24,16,8,0,1,2,3,11,12,20,21,29,37;13,5,4;10,9,17,25,33,41,49
8,0,23,7;49,41,42,43,44;52,51,50,58,57,56,48,40,32,24,16,8,0;10,18,19,20,21,22;33,34,35,36,37,45,53;11,3,2,1,9,17,25,26,27,28,29,30,38,46,54;7,6,5,4,12;59,60,61,62,63,55,47,39,31,23,15,14,13
8,0,24,7;37,29,21;1,0,8,16,24,32,40,48,56;45,44,36,28,20,12,13,14,22,30,38;25,33,41,49,57;2,3,4,5,6,7,15,23,31,39,47,55,63,62,61,60,59,58,50,42,34,26,18,17,9;19,11,10;27,35,43,51,52,53,54,46
8,0,25,7;11,19,20,21,29,37,45,53,61,60,59,58;48,40,41,42,43;12,13,14,22,30,38,46,54;35,34,33,32,24,16,8,9;56,57,49,50,51,52,44,36,28,27,26,25;62,63,55,47,39,31,23,15,7,6,5,4,3;17,18,10,2,1,0
8,0,26,8;46,54,53,52,51,50,49,48,40;26,27,19,20,12,13,14,22,30,38,37,45;18,10,2,1,0;8,16,24,32,33,41,42;56,57,58,59,60,61,62,63,55,47,39,31,23,15,7,6,5,4,3,11;9,17,25;34,35,43,44;36,28,29,21
8,0,27,7;60,61,62,63,55;28,27,26,34,42;29,21,20,19,18,17,25,33,41,49,50;45,44,52;59,58,57,56,48,40,32,24,16,8,0,1,2,3,4,5,6,7,15;53,54,46,47,39,31,23;9,10,11,12,13,14,22,30,38,37,36,35,43,51
8,0,28,7;33,34,26,18,19,20,28,36,44;27,35,43,42,41;59,58,57,56,48,40,32,24,16,8,0,1,2,3,4,5,6,7,15;21,29,37,45,53,52,51,50,49;11,12,13,14,22,23,31,39,47,55,63;60,61,62,54,46,38,30;25,17,9,10
8,0,29,6;34,33,25,17,9,1,2,3,4,5,6,7;59,60,61,62,63,55,47,39,38,30,29,28,20,19;45,44,43,42,41,49;14,15,23,31;22,21,13,12,11,10,18,26,27,35,36,37;46,54,53,52,51,50,58,57,56,48,40,32,24,16,8,0
8,0,30,7;51,52,53,54,46,38,37,36,28,20,12;18,26,34;49,41,33,25,17,9,10,11,19,27,35;45,44,43,42,50;6,7,15,23,31,39,47,55,63,62,61,60,59,58,57,56,48,40,32,24,16,8,0,1,2,3,4;30,22,14;5,13,21,29
9,0,1,9;40,31,30,29,28,19,10;39,38,37;12,13,14,15,16,25;56,57,58,59,60,51,42,43,44,35,26,17,8,7,6,5,4,3,2,1,0,9,18,27,36,45;24,23,22;21,20,11;34,33,32,41,50,49,48,47,46;64,65,66,67,68,69,70,61,52;55,54,63,72,73,74,75,76,77,78,79,80,71,62,53
9,0,2,8;65,56,47,38,29,30;39,48,57,66,75;34,25,16,15,6,5,4,3,2,1,0;74,73,72,63,54,45,36,37,28,19,20,21,22,31,40,49;46,55,64;43,52,61,70,69,68;32,41,50;27,18,9,10,11,12,13,14,23,24,33,42,51,60,59,58,67,76,77,78,79,80,71,62,53,44,35,26,17,8,7
9,0,3,7;32,41,50;7,8,17,26,35,44;40,31,22,21,20,19,10;33,24,23,14,13,12,11;18,9,0,1,2,3,4,5,6,15,16,25,34,43,42,51,60,59,58,57,56,47,38;49,48,39,30,29,28,37,46,55,64,65,66,67,68,69,70,61,52,53;62,71,80,79,78,77,76,75,74,73,72,63,54,45,36,27
9,0,4,7;35,26,25,24,23,32,41,40;17,16,15,14,13,22,31;80,79,70,61,52,43,44;34,33,42,51,60,69,78,77,76,75,74,73,72,63,54,45,36,27,18,9,0;1,10,19,28,37,46,55,64,65,66,67,68,59,50,49,48,39,30,21,12;8,7,6,5,4,3,2,11,20,29,38,47,56,57,58;71,62,53
9,0,5,8;48,57,66,67,68,69,70;0,1,2,11,20,29,30;16,25,34,43,42,51,60,59;33,24,15,14,13;9,10,19,28,37,46,55,64;61,52,53,44,35,26,17,8,7,6,5,4,3,12,21,22,31,40,39,38,47,56,65;62,71,80,79,78,77,76,75,74,73,72,63,54,45,36,27,18;58,49,50,41,32,23
9,0,6,10;70,69,60,51,42;76,75,74,73,72;58,49,50,41,32;13,12,11,10;63,64,65,56,47,38,29,30,31;40,39,48,57,66,67;33,24,23,22,21,20,19,28,37,46,55,54;59,68,77,78;61,52,43,34,25,16,15,14;79,80,71,62,53,44,35,26,17,8,7,6,5,4,3,2,1,0,9,18,27,36,45
9,0,7,10;28,29,20,11;19,10,1,2,3,12,13,22,31,40,49,58;25,34,43,52;72,63,54,45,36,27,18,9,0;60,69,78,77,76,75,74,73,64,55,46,37,38;57,48,39,30,21;71,62,53,44,35,26,17,8,7,6;80,79,70,61;16,15,24,33,42,51;47,56,65,66,67,68,59,50,41,32,23,14,5,4
9,0,8,8;61,52,43;67,66,65,64,55,46,37,28,29,30,31,22,13,12,11,10,9;0,1,2,3,4,5,6,7,8,17;60,51,50,49,48,57,56;26,25,24,23,32;21,20,19,18,27,36,45,54,63,72,73,74,75,76,77,78,79,80;16,15,14;58,59,68,69,70,71,62,53,44,35,34,33,42,41,40,39,38,47
9,0,9,8;67,68,69,70,61;41,32,23,14,15,16;0,9,18,27,36,45,54,63,72,73,74,75,76,77,78,79,80,71,62,53,44,35;60,59,58,57,66,65,64,55,46,37,28,19,10;30,21,12,3;25,34,43,52,51,50,49,48,47,56;24,33,42;1,2,11,20,29,38,39,40,31,22,13,4,5,6,7,8,17,26
9,0,10,7;20,21,22,23,32,41,50,59,60;55,56,47,38,37,36,27,18,9,0,1,2,3,4,5,6,7,8,17,26,35,44,53,62;80,79,78,69;39,48,57,66,65,64;71,70,61,52,43,34,25,16,15,14,13,12,11,10,19,28,29,30,31,40,49,58,67,68;46,45,54,63,72,73,74,75,76,77;51,42,33,24
9,0,11,9;59,50,41,32,31,22,21,12,11;77,68,67,66,65;38,47,48;0,9,18,19,20,29,30,39;70,61,52,43,34,25,16,15,14,13;10,1,2,3,4,5,6,7,8,17,26,35,44,53,62,71,80,79,78,69,60,51,42,33,24,23;40,49,58,57,56,55,64,73,74,75,76;72,63,54,45,36;27,28,37,46
9,0,12,8;57,48,49,50,51,42,33,24,23,14,5,6,7,8,17,26,35,44,53,62,71,80,79,78,77,76,75,74,73,72,63,54,45,36,27,18,9,0,1;2,11,12,21;28,37,46,55,64,65,66,67,58;22,13,4,3;10,19,20,29,30,31,32,41;40,39,38,47,56;68,69,70;59,60,61,52,43,34,25,16,15
9,0,13,8;49,48,57,66,75;64,55,46,37,28,19,10,11,12,13,14,15,16;31,32,33,34,43,52;20,21,22,23,24,25;70,61,60,51,42,41;69,68,59,50;38,47,56,65,74,73,72,63,54,45,36,27,18,9,0,1,2,3,4,5,6,7,8,17,26,35,44,53,62,71,80,79,78,77,76,67,58;29,30,39,40
9,0,14,9;41,40,39,38,37,36,27,18,9,0,1,2,3,12;57,66,67,68,69,70,61,52;58,59,60;56,65,74,75,76,77,78,79,80,71,62,53,44;63,54,45,46,47,48,49,50,51,42,43,34,35,26,17,8,7,6,5,4,13;72,73,64,55;24,33,32,31;10,11,20,21,22,23,14,15,16,25;30,29,28,19
9,0,15,7;56,57,58,59,68,69,70,61,52;23,14,15,16,25,34,43,42,51,60;27,36,37,46,47,48,49,50,41,32,33,24;3,12,21,30;45,54,55,64,65,66,67,76,77,78,79,80,71,62,53,44,35,26,17,8,7,6,5,4,13,22,31,40,39,38,29,20,11,2,1,0,9,18;75,74,73,72,63;28,19,10
9,0,16,9;61,62,53,44,35,26,17,8,7,6,5,4,3;18,27,28,29;51,60,59,58,57,56;24,23,22,13,12,11,2,1,0,9;33,32,31,40,49,48,47,46,55,64,65,66,67;34,25,16,15,14;70,69,68,77,76,75,74,73,72,63,54,45,36,37,38,39,30,21,20,19,10;78,79,80,71;52,43,42,41,50
9,0,17,6;57,48,49,40,41,42,43,34,25,16;32,33,24,15,14,5,4,3,2,1,0,9;56,47,38,39,30,31;6,7,8,17,26,35,44,53,52,51,50,59,58,67,66,65,64,55,46,37,28,29,20,21,22,23;78,79,70;80,71,62,61,60,69,68,77,76,75,74,73,72,63,54,45,36,27,18,19,10,11,12,13
9,0,18,9;65,56,47,38,29,20,21,22,23,14,15;40,49,58,67,68,69;64,55,46,37,28,19,10,11,12,13;41,42,43,34,25,16,7,6,5,4,3,2,1,0,9,18,27,36,45,54,63,72,73,74,75,76,77,78;79,70,61,60,59;8,17,26,35,44,53,62,71,80;50,51,52;39,48,57,66;30,31,32,33,24
9,0,19,9;69,60,59,58,57,48,39,30;7,8,17,26,35,34,33,32,41;15,6,5,4,3,2,1,0,9,18,27,36,45,54,63,72,73,74,75,76,77,78,79,70,61,52;42,51,50,49,40,31;46,55,64,65,66,67,68;80,71,62,53,44,43;12,11,10,19,28,37;13,14,23,24,25,16;22,21,20,29,38,47,56
9,0,20,9;22,13,14,5;33,42,41,50,49,58,67,66,65,64,55,46,37,28;10,11,12,21,30,39,48,57;56,47,38,29,20,19,18,9,0,1,2,3,4;59,68,77,76,75,74,73,72,63,54,45,36,27;16,25,34,43,44,53,62;80,79,78,69,60,51;40,31,32,23,24,15,6,7,8,17,26,35;52,61,70,71
9,0,21,7;41,42,43,52,61;51,60,69,70,71,62,53,44;6,5,4,3,2,1,0,9,18,27,36,45,54,63,72,73,74,75,66,57,56,47,38,29,20,21,22,23,24,25,16;80,79,78,77,68,59,50,49,40;76,67,58;15,14,13,12,11,10,19,28,37,46,55,64,65;48,39,30,31,32,33,34,35,26,17,8,7
9,0,22,9;53,44,35,34,25,24;43,52,61,62,71,80,79,78,77,76,75,74,73,72,63,54,45,36,37,38,47;65,64,55,46;56,57,66,67,68,59,50,41,32,23,14,15,16,17,26;58,49,48,39,30,29,28,27,18,9,0,1,2,3,4;70,69,60,51,42,33;19,10,11,12,13;5,6,7,8;40,31,22,21,20
9,0,23,9;61,52,51,50,49,40,31,30;24,33,34,43,44,53,62,71,80,79;36,45,54,63,72;58,57,48,39,38,29,20,21,22;13,12,11,10,19;17,8,7,6,5,4,3,2,1,0,9,18,27,28,37,46,55,64,73,74,75,76,77,78,69,70;15,16,25,26,35;42,41,32,23,14;60,59,68,67,66,65,56,47
9,0,24,8;70,61,60,59,50,41,32,31,30,21;12,3,4,5,6,7,8,17,26,35,44,53;10,19,28,37,46,55,64,65,66,57,48,39;22,23,24,33,42,51,52;2,1,0,9,18,27,36,45,54,63,72,73,74,75,76,77,78,79,80,71,62;69,68,67,58,49,40;11,20,29,38,47,56;43,34,25,16,15,14,13
9,0,25,8;60,51,52,53,44,35,26,17,16,15,14;62,71,80,79,78,77,76,75,74,73,64,55,46,37,28,19,10,1;57,48,49,40,31,32,33,34,25;61,70,69,68,67,66,65,56,47,38,29,20,11,2;43,42,41,50,59,58;0,9,18,27,36,45,54,63,72;39,30,21,12,3,4,5,6,7,8;24,23,22,13
9,0,26,9;13,12,11,10,19;4,3,2,1,0,9,18,27,28,29,30,31,32;67,76,75,74,73,72;20,21,22,23,14,5,6,7,8,17,26,35,44,53,62,61,60;69,70,71;25,34,43,52,51;36,45,54,63,64,65,66;16,15,24,33,42,41,50,49,48,47;80,79,78,77,68,59,58,57,56,55,46,37,38,39,40
9,0,27,8;72,73,64,55,56,47,48;74,75,76,67;16,15,14,13,12,11,10,9,18,27,36,45,54,63;35,44,53,62,71,80,79,78,77;39,40,49,58,59,68,69,70,61,52,43,34,25,26,17,8,7,6,5,4,3,2,1,0;60,51,50,41,32,31,30,29,38,37,46;28,19,20,21,22,23,24,33,42;57,66,65
9,0,28,7;64,55,46,47;74,73,72,63,54,45,36,27,18,9,10,11,12,13,14,15,16,25,34,43,52,61,70;75,66,65,56;0,1,2,3,4,5,6,7,8,17,26,35,44,53,62,71,80,79,78,69,60,51,42,33,24,23,22,21,20,19,28;37,38,29,30,31,32,41,50,49;76,67,58,57,48,39,40;59,68,77
9,0,29,8;43,44,53,62,71,80,79,78,77,76,75,74,65,64,55,46,47,48,49,50;66,67,68,69,70,61,52;41,32,31,30,29,28,37;56,57,58,59,60,51,42,33,24,25;13,12,11,10,9;0,1,2,3,4,5,6,7,8,17,26,35,34;16,15,14,23,22,21,20,19,18,27,36,45,54,63,72,73;40,39,38
9,0,30,9;6,5,4,3,12,21;37,46,55,64,73,74,75,76,67,58,57,48,39,40,41,32,23,24,25,26,17,8;72,63,54,45,36,27,28,19,10;62,53,44,35,34,33,42,51,60;70,61,52,43;7,16,15,14,13,22,31,30;69,68,59,50,49;18,9,0,1,2,11,20,29,38,47,56,65,66;71,80,79,78,77
