7,0,1,4;36,37,38,31,32,33,40;39,46,47,48,41,34,27,26,25,24,23,30,29;12,11,10,9,8,15,22;16,17,18,19,20,13,6,5,4,3,2,1,0,7,14,21,28,35,42,43,44,45
8,0,2,4;63,55,47,39,31,23,15,7,6,5,4,3,2,1,9,17,18,19,20,28,36,44,43,42,34,33,32,40;41,49,50,51,52,53,45,37,29,21,13,12,11,10;35,27,26,25,24,16,8,0;48,56,57,58,59,60,61,62,54,46,38,30,22,14
8,0,3,5;54,46,38,30,29,28,27,26,18;61,62,63,55,47,39,31,23,22,21,20,19;15,14,13,12,11,10,9,17,25,33,41,49,50,51;53,45,37,36,35,34;42,43,44,52,60,59,58,57,56,48,40,32,24,16,8,0,1,2,3,4,5,6,7
9,0,4,4;50,41,32,31,30,39,48,57,66,67,68,69,70,71,62,53,44,35,26,17,8,7,6,5,4,3,2,1,0,9,18,27,36,45,54,63,72;40,49,58,59,60,61;80,79,78,77,76,75,74,65,56,47,38,29,20,21,22,23,24,33,42,51,52;43,34,25,16,15,14,13,12,11,10,19,28,37,46,55,64,73
9,0,5,4;31,40,39,38,37,36,27,18,9,0;54,63,72,73,74,75,76,67,68,69,70,61,52,43,34,25,16,15,14,13,12,11,20;45,46,55,64,65,66,57,58,59,60,51,42,33,24,23,22,21,30,29,28,19,10,1,2,3,4,5,6,7,8,17,26,35,44,53,62,71,80,79,78,77;56,47,48,49,50,41,32
10,0,6,6;72,73,74,75,76,77,67,57,47,37,36;62,61,71,81,82,83,84,85,86,87,88,78,68,58,48,38;55,54,44,43,42,41,40;1,2,12,13,14,15,16,17,18;20,30,31,32,33,34,35,45,46,56,66,65,64,63,53,52,51,50,60,70,80,90,91,92,93,94,95,96,97,98,99,89,79,69,59,49,39,29,19,9,8,7,6,5,4,3;28,27,26,25,24,23,22,21,11,10,0
10,0,7,5;52,42,43,33,23,13,3,2,1,0,10;99,89,79,69,59,49,39,29,19,9,8,7,6,5,4,14,24,34,44,54,53;27,37,47,57,67,77,87,86,85,84,83,82,81,80,70,60,50,40,30,20,21;62,63,64,65,55,45,35,25,15;11,12,22,32,31,41,51,61,71,72,73,74,75,76,66,56,46,36,26,16,17,18,28,38,48,58,68,78,88,98,97,96,95,94,93,92,91,90
10,0,8,6;55,65,75,85,95,96,97,98,99;91,92,93,94,84,74,64,54,44,45;81,82,83,73,63,53,43,33,34,35,36,46,56,66,76,86,87,88,89;59,69,79,78,77,67,57,47,37,38,28,18,17,16,15,14,13,12,11,21,31,41,51,61;68,58,48,49,39,29,19,9,8,7,6,5,4,3,2,1,0,10,20,30,40,50,60;90,80,70,71,72,62,52,42,32,22,23,24,25,26,27
10,0,9,5;18,17,16,15,14,13,12,11,21,31,41,51,61,71,81,82,83,84,85;72,73,74,75,65,55,56,57,67,77,87,97,98;66,76,86,96,95,94,93,92,91,90,80,70,60,50,40,30,20,10,0,1,2,3,4,5,6,7,8,9,19,29,28,27,26,25,24,23,22,32,42,52,62;64,63,53,43,33,34,35,36,37,38,39,49,59,69,79;54,44,45,46,47,48,58,68,78,88,89,99
10,0,10,5;18,28,27,26,25,35,45,44,54,64,74,84,85,86,87,88,89,79,69;59,58,68,78,77,76,75,65,55,56,46,36,37,38,39,29,19,9,8,7,6,5,4,3,2,1,0,10,20,30,40,50,60,70,80,90,91,92,82,72,62,52,42,32,22,23;81,71,61,51,41,31,21,11,12,13;99,98,97,96,95,94,93,83,73,63,53,43,33,34,24,14,15,16,17;49,48,47,57,67,66
7,0,11,4;36,37,38,39,40,33,26,19,12,11,10;31,30,29,28,35,42,43,44,45,46,47,48,41,34,27,20,13,6,5,4,3,2,9;0,7,14,21,22,23,24,25,32;1,8,15,16,17,18
8,0,12,4;41,33,25,17,9,1,2,3,4,5,6,7,15,23,31,39,47,55,63,62;54,46,38,30,22,14,13,12,11,10,18,26,34;0,8,16,24,32,40,48,49,50,42,43,35,27,19,20,21,29,37,45,53,61,60;56,57,58,59,51,52,44,36,28
8,0,13,6;4,3,2,10,9,17,25,33;14,22,21,20,28,27;1,0,8,16,24,32,40,41,42,34,35,36,37,38,39,47,55,63,62,61;48,49,50,51,43,44,45,46;26,18,19,11,12,13,5,6,7,15,23,31,30,29;54,53,52,60,59,58,57,56
9,0,14,4;40,31,22,23,24,25,16;42,51,60,59,58,57,56,47,38,29,20,11,2,3,4,5;1,10,19,28,37,46,55,64,65,66,67,68,69,70,61,52,43,34,33,32,41,50,49,48;39,30,21,12,13,14,15,6,7,8,17,26,35,44,53,62,71,80,79,78,77,76,75,74,73,72,63,54,45,36,27,18,9,0
9,0,15,4;41,40,31,22,13,4,5,6;8,7,16,15,14,23,32,33,42,51,50,49,48,39,30,21,12,3,2,1,0,9,18,27,36,45,54,63,72,73,74,75,76,77,78,79,80;11,20,29,38,47,56,57,58,59,60,61,52,43,34,25,24;17,26,35,44,53,62,71,70,69,68,67,66,65,64,55,46,37,28,19,10
10,0,16,5;1,11,21,31,41,51,61,71,81,82,83,84;0,10,20,30,40,50,60,70,80,90,91,92,93,94,95,85,75,74,73,72,62,52,42,32,22,12,2,3,4,5,6,7,8,18;77,76,66,65,64,63,53,43,33,23,13,14,15,16,17,27,28,29,19,9;86,87,88,78,68,67,57,56,55,54,44,34,24,25,26,36,37,38,39,49;35,45,46,47,48,58,59,69,79,89,99,98,97,96
10,0,17,7;87,88,78,68,69,59,49,39,29,19,9,8,7,6,5,4,3,2,1,0,10,20,30,40,41,42;61,62,63,64,54,44,34,35;36,46,45,55,65,75,74,73,72;71,81,82,83,84,85,86,76,77,67;33,43,53,52,51,50,60,70,80,90,91,92,93,94,95,96,97,98,99,89,79;58,48,38,28,18,17,16,15,14,13,12,11,21,31,32;22,23,24,25,26,27,37,47,57,56,66
10,0,18,5;11,10,20,30,40,50,60,70,80,90,91,92,93,94,95,96,97,98,99,89,79,69,59,49,39,29,19,9,8,7,17,27,37,47,57,67,77,76,75,74,73,72,62,52,42,32,22,23,24,34,44,54,55;33,43,53,63,64,65,66,56;45,35,25,15,14,13,12;46,36,26,16,6,5,4,3,2,1,0;21,31,41,51,61,71,81,82,83,84,85,86,87,88,78,68,58,48,38,28,18
10,0,19,4;72,73,74,75,76,77,67,57,47,37,27,17,16,15,14,13;2,1,11,21,31,32,33,34,35,45,55,54,53,52,51,50,60,70,80,90,91,92,93,94,95,96,97,98,99,89,79,69,59,49,39,29,19,9;12,22,23,24,25,26,36,46,56,66,65,64,63,62,61,71,81,82,83,84,85,86,87,88,78,68,58,48,38,28,18,8,7,6,5,4,3;0,10,20,30,40,41,42,43,44
10,0,20,6;12,2,3,4,5,6,7,8,9,19,29,39,49,59,69,79,89,99,98,97,96,95,94,93,92,91,81,71,61,51,52,53,63;82,83,84,85,86,87,88,78,68,58,48,38,28,18;54,55,45,35,34,33,32,31,30,20,10,0,1;44,43,42,41,40,50,60,70,80,90;75,76,77,67,57,47,37,27,17,16,15,14,13;11,21,22,23,24,25,26,36,46,56,66,65,64,74,73,72,62
7,0,21,4;15,8,9,10,11,12,19,26,33,32;24,31,30,29,28,35,42,43,44,45,46,47,48;36,37,38,39,40,41,34,27,20,13,6,5,4,3,2,1,0,7,14;21,22,23,16,17,18,25
8,0,22,6;47,55,63,62,61,60,52,44,36,28,20,21,13;7,15,23,31,39,38,46,54,53;27,35,43,51,59,58,57,49;12,11,19,18,26,34,42,50;32,24,16,8,0,1,2,3,4,5,6,14,22,30,29,37,45;10,9,17,25,33,41,40,48,56
8,0,23,4;61,62,54,46,38,30,22,14,13,12,11,19,18,26,34,35;63,55,47,39,31,23,15,7,6,5,4,3,2,10,9,17,25,33,41,42;49,50,51,43,44,36,28,27;20,21,29,37,45,53,52,60,59,58,57,56,48,40,32,24,16,8,0,1
9,0,24,4;11,10,19,28,37,46,55,64,65,66,67,68,69,70,61,52,43;44,53,62,71,80,79,78,77,76,75,74,73,72,63,54,45,36,27,18,9,0,1,2,3,12,21,20,29,38,47,56,57,58,59,60,51,42,33,24;34,25,16,15,14,23,32,41,50,49,48,39,30;35,26,17,8,7,6,5,4,13,22,31,40
9,0,25,4;9,0,1,2,3,4,13,22,31,40,49,48;50,41,32,23,14,5,6,7,8;17,16,25,34,43,52,61,70,69,68,67,66,65,64,55,46,37,28,29,20;15,24,33,42,51,60,59,58,57,56,47,38,39,30,21,12,11,10,19,18,27,36,45,54,63,72,73,74,75,76,77,78,79,80,71,62,53,44,35,26
10,0,26,7;12,22,23,33,43,44,45,46;13,14,24,34,35,36,37,47,57,56;25,15,5,4,3,2,1,11,21,31,32,42,52,53,54,55;88,87,86,85,84,83,82,81,71,70,60,50;17,18,28,38,48,58,68,67,66,65,64,63;78,77,76,75,74,73,72,62,61,51,41,40,30,20,10,0;27,26,16,6,7,8,9,19,29,39,49,59,69,79,89,99,98,97,96,95,94,93,92,91,90,80
10,0,27,5;47,37,27,26,25,24,23,22,21,31,41,51,61,71,81,82,83,84,85,86,87,88;67,66,65,55,45,44,43,53,63;0,1,2,3,4,5,6,7,8,9,19,29,39,49,59,69,68,78,77,76,75,74,64,54;73,72,62,52,42,32,33,34,35,36,46,56,57;58,48,38,28,18,17,16,15,14,13,12,11,10,20,30,40,50,60,70,80,90,91,92,93,94,95,96,97,98,99,89,79
10,0,28,6;56,57,67,77,76,75,74,73,72,71,81,91,92,93,94,95,96,97,98,99,89,79,69,59,49,39,38,28,18,17,16,15,14,13,23;35,45,55,54,53,52,51,50,40,30,20,10,0,1,2,3,4,5,6,7,8,9,19,29;12,11,21,31,41,42,43,44;37,27,26,25,24,34,33,32,22;36,46,47,48,58,68,78,88,87,86,85,84,83,82;90,80,70,60,61,62,63,64,65,66
10,0,29,5;61,51,41,31,21,11,12,13,14,15,16,17,18,28,38,48,58,68,78,88;54,53,52,62,72,71,81;96,86,87,77,67,57,47,37,27,26,25,24,23,22,32,42,43,44,45,55,65,64,74,84,94,93;63,73,83,82,92,91,90,80,70,60,50,40,30,20,10,0,1,2,3,4,5,6,7,8,9,19,29,39,49,59,69,79,89,99,98,97;95,85,75,76,66,56,46,36,35,34,33
10,0,30,5;32,33,34,35,45,55,65,75,85,84,83,82,81;53,63,62,61,60,50,40,30,20,10,0;22,23,24,25,26,36,46,56,66,76,86,96,95,94,93,92,91,90,80,70,71,72,73,74,64,54,44,43,42,52,51;41,31,21,11,1,2,3,4,5,6,7,8,9,19,29,39,49,59,69,79,89,99,98,97,87,77,67,57,47,37,27;88,78,68,58,48,38,28,18,17,16,15,14,13,12
