8,0,1,4;40,48,56,57,58,59,60,61,62,63,55,47,39,31,23,15,7,6,5,4,3,2,10,18,19,20,28;41,49,50,51,52,53,54,46,38,30,22,14,13,12,11;1,9,17,25,26,27,35,36;0,8,16,24,32,33,34,42,43,44,45,37,29,21
9,0,2,4;71,70,69,68,67,66,65,64,55,46,37,28,19,10,11,12,13,14,23,32,31,30,39,48,49,50,51,52,53,44,35,26,17;8,7,16,25,34,43,42,41,40;33,24,15,6,5,4,3,2,1,0,9,18,27,36,45,54,63,72,73,74,75,76,77,78,79,80;62,61,60,59,58,57,56,47,38,29,20,21,22
10,0,3,5;66,65,64,63,53,43,33,34;54,44,45,35,25,24,23,22,32,42,52,62,72,73,74,75,76,77,67,68,69,79,89,99,98,97,96,95,94,93,92,91,90,80,70,60,50,40,30,20,10,0,1,2,3,4,5,6;78,88,87,86,85,84,83,82,81,71,61,51,41,31,21,11,12,13,14,15,16,26;55,56,57,58,59,49,39,29,19,9,8,7,17,27,37,36;46,47,48,38,28,18
9,0,4,5;40,31,22,13,14,15,16,25;51,60,59,58,57,56,47,38,29,20,11,2,1,0,9,18,27,36,45,54,63,72,73,74,75,76,77,78,79,80,71,62;44,43,42,33,24,23;32,41,50,49,48,39,30,21,12,3,4,5,6,7,8,17,26,35,34;53,52,61,70,69,68,67,66,65,64,55,46,37,28,19,10
8,0,5,4;54,53,52,51,50,49,41,33,25,17,9,10,11;21,20,19,18,26,34,42,43,44,45,46,47,55,63,62,61,60,59,58,57,56,48,40,32,24,16,8,0,1,2;3,4,12,13,14,22,30,29,28;5,6,7,15,23,31,39,38,37,36,35,27
9,0,6,5;70,61,60,59,58,49,48;0,1,2,3,4,5,6,7,8,17,26,35,44,43,42,33,32,31,30,29,38,47,56,57;24,23,22,21,20,19,28,37,46,55,64,65,66,67;68,77,76,75,74,73,72,63,54,45,36,27,18,9,10,11,12,13,14,15,16,25,34;69,78,79,80,71,62,53,52,51,50,41,40,39
10,0,7,6;36,35,25,24,23,22;27,26,16,6,5,4,3,2,1,0,10,20,30,40,50,60,70,80,90,91,92,93,94,95,96,97,98,99,89;18,28,38,48,58,68,67,66,65,64,63,53,43;15,14,13,12,11,21,31,41,51,61,71,81,82,83,84,85,86,87,88;46,45,44,34,33,32,42,52,62,72,73,74,75,76,77,78,79,69,59,49,39,29,19,9,8,7,17;37,47,57,56,55,54
9,0,8,4;48,39,30,21,12,13,4,5,6,7,8,17,26,35;0,9,18,27,36,45,54,63,72,73,74,75,76,77,78,79,80,71,62,53,44,43,34,25,16,15,14,23,22,31,40,49,58,57,56,47,38,29,20,11,2,3;60,59,50,41,32,33,24;42,51,52,61,70,69,68,67,66,65,64,55,46,37,28,19,10,1
8,0,9,4;36,35,27,19,11,3,4,5,6,7;23,15,14,13,12,20,28,29,37,38,46,54,53,52,51,50,49,41,33,25,17,9,8,0;1,2,10,18,26,34,42,43,44,45;21,22,30,31,39,47,55,63,62,61,60,59,58,57,56,48,40,32,24,16
9,0,10,5;16,25,34,43,52,61,70,69,68,67,66,65,64;39,38,37,36,45,54,63,72,73,74,75,76,77,78,79,80,71,62,53,44,35,26,17,8,7,6,5,4,3,2;47,48,49,50,41,32,23,22,21,20,19,10,1;40,31,30,29,28,27,18,9,0;11,12,13,14,15,24,33,42,51,60,59,58,57,56,55,46
10,0,11,6;9,8,18,28,38,48,58,57,56,66,65;63,64,54,55,45,46,47,37,27,17,7,6,5,15,25;33,34,35,36,26,16;13,12,11,21,31,41,51,61,71,81,82,83,84,85,86,87,88;19,29,39,49,59,69,68,67,77,76,75,74,73,72,62,52,53,43,44;42,32,22,23,24,14,4,3,2,1,0,10,20,30,40,50,60,70,80,90,91,92,93,94,95,96,97,98,99,89,79,78
9,0,12,5;10,11,12,13,22,31,40,41;58,57,56,47,38,29,28,27,36,45,54,63,72,73,74,75,76,77,78,79,80,71,62,53,44,35,26;37,46,55,64,65,66,67,68,69,70,61,52,43,34,25,24;17,8,7,6,5,4,3,2,1,0,9,18,19,20,21,30,39,48,49,50;16,15,14,23,32,33,42,51,60,59
8,0,13,4;42,50,58,59,60,61,62,63,55,47,39,31,23,15,7,6,5,4,3,2,1,0,8,16,17,18,19,20,21,29,37;57,49,41,33,34,35,43,44,45;56,48,40,32,24,25,26,27,28,36;51,52,53,54,46,38,30,22,14,13,12,11,10,9
9,0,14,4;80,71,62,53,44,43,42,41,40,49;60,69,68,67,66,65,64,55,46,37,28,19,10,11,12,13,14,15,16,7,8;35,34,33,32,31,30,39,48;6,5,4,3,2,1,0,9,18,27,36,45,54,63,72,73,74,75,76,77,78,79,70,61,52,51,50,59,58,57,56,47,38,29,20,21,22,23,24,25,26,17
10,0,15,5;88,78,68,58,48,38,28,18,8,7,6,5,4,3,2,1,0,10,20,30,40,50,60,70,80,90;55,56,66,76,86,96,95,94;9,19,29,39,49,59,69,79,89,99,98,97,87,77,67,57,47,46,45,44,54,64,65,75,85,84,83;91,81,71,61,51,41,31,21,11,12,13,14,15,16,17,27,37,36,35,34,33,43,53,63,73,74;93,92,82,72,62,52,42,32,22,23,24,25,26
9,0,16,5;34,25,24,23,22,31,40;8,7,16,15,14,13,12,21,30,39,48,49,50,41;20,29,38,47,56,57,58,59,60,51,52,53,62,71,80,79,78,77,76,75,74,73,72,63,54,45,36,27,18,9,0,1;32,33,42,43,44,35,26,17;6,5,4,3,2,11,10,19,28,37,46,55,64,65,66,67,68,69,70,61
8,0,17,4;27,28,20,12,4,5,6,7;45,44,43,42,34,26,18,19,11,3,2,1,0,8,16,24,32,40,48,56,57,58,59,60,61,62,63,55,47,39,31,23,15;10,9,17,25,33,41,49,50,51,52,53,54,46,38,30,22;14,13,21,29,37,36,35
9,0,18,6;40,49,58,67,76,77,78,79,80,71,62,53,52;70,69,68,59,50,41;56,57,66,75,74,73,72,63,54,45,36,27,18,9,0,1,2,3,4,5,6,7;61,60,51,42,43,44,35,26,25,24,23,22,21,20,29,38;65,64,55,46,37,28,19,10,11,12,13,14,15,16,17,8;47,48,39,30,31,32,33,34
10,0,19,6;96,95,94,93,92,91,90,80,70,60,61,62,63,53,43,33,23,24,25,26,27;41,31,21,11,1,2,3,4,5,6,7,8,9,19,29;37,47,57,67,77,78,88;59,49,39,38,28,18,17,16,15,14,13,12,22,32,42,52,51,50,40,30,20,10,0;45,55,65,75,85,84,83,82,81;48,58,68,69,79,89,99,98,97,87,86,76,66,56,46,36,35,34,44,54,64,74,73,72,71
9,0,20,4;27,18,19,20,21,22,23,24,33,42,51,60,59,58,57,56,65,74,75,76,77,78,79,80,71,62,53,44,35,26,17,8,7,6,5,4,3,2,1,0;28,29,30,31,32,41,50,49,48,47,46,55,64;9,10,11,12,13,14,15,16,25,34,43,52,61,70,69,68,67,66;73,72,63,54,45,36,37,38,39,40
8,0,21,5;55,63,62,61,60,59,51,50,42,34,26,18;38,30,22,14,13,12,20,28,36;52,53,54,46,47,39,31,23,15,7,6,5,4,3,2,1,0,8,16,24,32,40,48,56;35,27,19,11,10,9,17,25,33,41,49,57,58;43,44,45,37,29,21
9,0,22,4;64,65,66,67,68,69,70,61,52,43,34,25,24,23,22,21;63,72,73,74,75,76,77,78,79,80,71,62,53,44,35,26,17,16,15,14,13,12,11,20,29,30,31,32,33;50,49,48,47,46,45,36,27,18,9,0;8,7,6,5,4,3,2,1,10,19,28,37,38,39,40,41,42,51,60,59,58,57,56,55,54
10,0,23,5;19,18,28,38,48,58,57,56,55;88,87,86,85,84,83,82,81,71,61,51,41,31,21,11,12,13,14,15,25,35,34,33,43,53,63,64,65,66,67,68,69,59,49,39,29;36,26,16,6,5,4,3,2,1,0,10,20,30,40,50,60,70,80,90,91,92,93,94,95,96,97;9,8,7,17,27,37,47,46,45,44,54;98,99,89,79,78,77,76,75,74,73,72,62,52,42,32,22,23,24
9,0,24,4;67,66,65,64,55,46,37,28,19,10,11,12,13,14,15,16,7,8;68,59,58,57,56,47,38,29,20,21,22,23,24,25,26,17;40,41,42,43,52,61,70,79,80;6,5,4,3,2,1,0,9,18,27,36,45,54,63,72,73,74,75,76,77,78,69,60,51,50,49,48,39,30,31,32,33,34,35,44,53,62,71
8,0,25,5;9,17,25,24,32,40,48,56,57,58,59,60,61,62,63;42,43,35,27,19,11,3,2,1,0,8,16;7,6,5,13,21,29,37;10,18,26,34,33,41,49,50,51,52,53,54,55,47,39,31,23;15,14,22,30,38,46,45,44,36,28,20,12,4
9,0,26,5;30,39,48,57,56,65;63,64,55,46,37,28,19,10,11,12,13,14,15,16,25,34,43,52,61,70;23,24,33,42,51,60,69,78,79,80,71,62,53,44,35,26,17,8,7,6,5,4,3,2,1,0,9,18,27,36,45,54;40,49,58,67,66,75,74,73,72;76,77,68,59,50,41,32,31,22,21,20,29,38,47
10,0,27,5;13,14,15,16,17,18,28,38,48,58,68,78,88,87,86,76,66,56,46,36,35,34,33,32,31,30,20,10;54,53,52,51,61,71,81,91,92,93,94;64,63,62,72,82,83,84,85,95,96,97,98,99,89,79,69,59,49,39,29,19,9,8,7,6,5,4,3,2,12;90,80,70,60,50,40,41,42,43,44,45,55,65,75,74,73;0,1,11,21,22,23,24,25,26,27,37,47,57,67,77
9,0,28,5;80,71,70,69,60,51,42,33,24;1,10,19,28,37,46,55,64,65,66,57,48,39,30,21,12;56,47,38,29,20,11,2,3,4,5,6,7,8,17,26,35,44,53;79,78,77,68,59,50,41,32,23;0,9,18,27,36,45,54,63,72,73,74,75,76,67,58,49,40,31,22,13,14,15,16,25,34,43,52,61,62
8,0,29,5;11,19,27,35,43,44,45,46,38,30,22,14;36,28,20,12,4,3,2,1,0;42,34,26,18,10,9,8,16,24,32,40,48,56,57,58,59,60,61,62,63,55,47,39,31,23;15,7,6,5,13,21,29,37;17,25,33,41,49,50,51,52,53,54
9,0,30,6;13,14,23,24,33,42,51,60,69,68;19,18,27,36,45,46,47,38,39,30;12,21,22,31,32,41,50,59,58,67,66,65,64;10,11,20,29,28,37;70,61,52,43,34,25,16,15,6,5,4,3,2,1,0,9;7,8,17,26,35,44,53,62,71,80,79,78,77,76,75,74,73,72,63,54,55,56,57,48,49,40
