7,0,1,6;20,27,34,41,48,47,46,45,44,43,42;40,39,32,25,18,11,4,5,6,13;7,0,1,2,3,10,17,24,31,30,29,22,15;8,9,16,23;14,21,28,35,36,37,38;33,26,19,12
7,0,2,6;6,5,4,11;29,22,23,24,25,26,27,20;40,39,38,45,44,43,42,35,28,21,14,15,16,17,18,19,12,13;46,47,48,41,34,33,32,31,30,37,36;9,8,7;10,3,2,1,0
7,0,3,6;36,37,38,39,40,41,34,27,20,13,6;3,10,11,18,25,24;23,22,15,8,1,0;7,14,21;4,5,12,19,26,33,32,31,30,29,28,35,42,43,44,45,46,47,48;2,9,16,17
7,0,4,6;8,9,16,17,24;32,25,18,11,10;44,37,36,29;43,42,35,28,21,14,7,0,1,2,3,4;5,6,13,20,27,34,41,48,47,46,45,38,31,30,23,22,15;12,19,26,33,40,39
7,0,5,5;33,32,25,24;46,45,44,37,36,29,22,15,8,9,10;6,5,4,3,2,1,0,7,14,21,28,35,42,43;20,13,12,11,18,17,16,23,30,31,38,39,40,47,48;19,26,27,34,41
7,0,6,7;11,10,9,8,15,14,21;36,37,30,31,24,17,18;42,43,44,45,38,39,32,25,26,19,12,5,6;4,3,2,1,0,7;48,41,34,27,20,13;46,47,40,33;35,28,29,22,23,16
7,0,7,6;28,35,42,43,44,45,46,47,48,41,34,27,20,13;7,8,15,16,17,24,25,26,19,12,5,6;23,30,31,32,33,40;4,3,2,1,0;39,38,37,36,29,22,21,14;18,11,10,9
7,0,8,6;39,32,25;19,18,17,24;34,41,48,47,46,45,44,37,36,29,22;40,33,26,27,20,13,6,5,4,3,2,1;12,11,10,9,8,7,0;38,31,30,23,16,15,14,21,28,35,42,43
7,0,9,5;38,39,32,25,18,11,10,9,8;31,24,17,16,15,22,29,36,35;48,41,34,27,20,13,6,5,4,3,2,1,0,7,14,21,28;12,19,26,33,40,47,46,45,44,43,42;23,30,37
7,0,10,6;30,29,28,35,42;23,22,21,14,7,0,1,2,3,4,5,6,13,20,27,34,41,40,39;16,17,18,25,32;36,43,44,45,46,47,48;37,38,31,24;15,8,9,10,11,12,19,26,33
7,0,11,6;12,11,10,9,8,15,22,29,36;30,23,16,17,18,19;48,41,40,39;31,32,33,34;45,46,47;24,25,26,27,20,13,6,5,4,3,2,1,0,7,14,21,28,35,42,43,44,37,38
7,0,12,7;33,32,25,18,17,16;42,43,44,45,46,47,48;20,13,6,5,4,3,2,1,0,7,14,21,28;9,10,11,12,19,26,27;35,36,37,30,23;8,15,22,29;24,31,38,39,40,41,34
7,0,13,5;8,9,10,11,12,19,26,33,40,39,38,45,44,43,42;21,28,35,36,37,30,31,32;18,17,16,15,14,7,0,1,2,3,4,5,6,13,20,27;25,24,23,22,29;46,47,48,41,34
7,0,14,6;25,24,23,22,21,14;28,29,30,31,32;6,5,4,3,2,1,0;9,10,11,18,19,26,33,40,39,38,37,36,35;7,8,15,16,17;12,13,20,27,34,41,48,47,46,45,44,43,42
7,0,15,5;38,31,32,33,26,19,12,11,10,9,8;37,30,23,24,25,18;41,40,39;36,29,22,15,16,17;48,47,46,45,44,43,42,35,28,21,14,7,0,1,2,3,4,5,6,13,20,27,34
7,0,16,5;12,13,20,27;6,5,4,11,18,19,26,33,34,41,48,47,46,45,38,31,30,23,16,9;14,21,28,35,42,43,44;7,0,1,2,3,10,17,24,25,32,39,40;37,36,29,22,15,8
7,0,17,7;43,44,37,30;28,21,14,7,0;16,17,24,31,38,45,46,47,48;23,22,15,8,1,2,3,4,5,6,13,20,27,34;42,35,36,29;41,40,33,26,19,12,11,10,9;39,32,25,18
7,0,18,8;5,4,3;6,13,12;44,43,42,35,28,21,14;0,1,2,9,16,17,24,25,26,27,34,41,48,47,46;39,38,45;29,36,37;10,11,18,19,20;7,8,15,22,23,30,31,32,33,40
7,0,19,7;24,31,38,39,46,47,48,41,34,27;6,5,4,3,10,17;42,43,44,45;26,19,20;8,15,22,29,28;40,33,32,25,18,11,12,13;21,14,7,0,1,2,9,16,23,30,37,36,35
7,0,20,7;24,17,16;4,3,2,1,0,7,14,21,28,35,42,43,44,45,46,47;5,6,13,20,27,26,33;48,41,34;12,19,18,25,32,31,30,23,22;11,10,9,8,15;29,36,37,38,39,40
7,0,21,8;41,40,39,38,31;43,42,35,28,21,14,7,0,1;30,23,24,25;18,11,4;5,6,13,20,27,34;32,33,26,19,12;3,2,9,8;48,47,46,45,44,37,36,29,22,15,16,17,10
7,0,22,6;42,43,44,37,30,23,24;16,17,18,19,26,33,40;31,38,45;47,48,41,34,27,20,13,6,5,4,3,2,1,0,7,14,21,28;12,11,10,9,8,15,22,29,36,35;25,32,39,46
7,0,23,7;30,37,44,43,42,35,28,21,14,15;23,22,29,36;31,32,33,26,19,12;46,47,48,41,34,27,20,13,6,5,4,11,18,25,24;16,9,8,7,0;45,38,39,40;1,2,3,10,17
7,0,24,7;28,35,42;43,44,37,30,23,16,15,8;27,20,13,6,5,4,3;41,40,39,32,25,18;21,22,29,36;34,33,26,19,12,11,10,9,2,1,0,7,14;48,47,46,45,38,31,24,17
7,0,25,6;22,29,36,37,38,39,40;33,26,19,12,11;47,48,41,34,27,20,13,6,5,4,3,2,1,0,7;17,16,23,30,31,32;18,25,24;10,9,8,15,14,21,28,35,42,43,44,45,46
7,0,26,6;30,37,38;25,26,33,40;42,35,28,21,14,7,0,1,2,3,4,5;12,11,10,9,16,23;6,13,20,27,34,41,48,47,46,45,44,43,36,29,22,15,8;19,18,17,24,31,32,39
7,0,27,7;0,1,2,3,4,5,6,13,20,19,18,25,24,23,30,37;41,34,27,26;43,44,45,46,39;40,47,48;12,11,10,17,16,15,22,29,36,35,42;38,31,32,33;9,8,7,14,21,28
7,0,28,5;37,30,23,24,25;42,35,28,21,14,7,0,1,2,3,4,5,6,13,20,27,34,41,48,47;16,17,18,19,26;33,40,39,46;32,31,38,45,44,43,36,29,22,15,8,9,10,11,12
7,0,29,6;40,33,26,19,12,11,10;1,2,3,4,5,6,13,20,27,34,41,48,47,46,45,44,43,42,35;24,31,30;28,29,36,37,38,39,32,25,18,17,16;23,22,15,8,9;0,7,14,21
7,0,30,5;8,15,22,29,36,37,38,39,40,33,26,19,12,13,6;18,11,4,5;20,27,34,41,48,47,46,45,44,43,42,35,28,21,14,7,0,1,2;25,24,17,10,3;32,31,30,23,16,9
7,0,31,6;14,7,0,1,2;48,41,34,27,20,13;6,5,12,19,26,25,24,31,30;32,39,38,37,36,29,22,15,8,9,10,3,4;21,28,35,42,43,44,45,46,47,40,33;11,18,17,16,23
7,0,32,6;7,14,21,28,35;48,41,34,27,26,19,12,11;42,43,44,37,30,23,16;18,25,32,33,40,47,46,45;36,29,22,15,8,9,10,17,24,31,38,39;0,1,2,3,4,5,6,13,20
7,0,33,6;7,0,1,2,3,4,5,6,13,20,27,26,33,40;34,41,48,47,46;28,21,14,15,8,9,10,11,12;35,36,29,22,23,16;37,30,31,24,17;19,18,25,32,39,38,45,44,43,42
7,0,34,7;34,27,26,19,12;48,41,40,33,32,25,18,11;23,30,37;10,9,8,15,22,29,36,43,44,45,46,47;39,38,31,24,17,16;4,5,6,13,20;3,2,1,0,7,14,21,28,35,42
7,0,35,7;18,19,20,27,34,41,48,47,46,45,44,43,42,35,28,29,22;6,13,12,11,10,17,24;21,14,7;32,31,30,23;15,8,1,0;16,9,2,3,4,5;25,26,33,40,39,38,37,36
7,0,36,5;1,0,7,14,15,16,17,10;40,39,38,37,36,29,22,23,24,25,18,11;21,28,35,42,43,44,45,46,47,48,41,34,27,20;13,12,19,26,33,32,31,30;6,5,4,3,2,9,8
7,0,37,5;43,44,45,46,47,48,41,34,27,26,25,32,31;6,13,20,19,18,17,16;5,12,11,10,9,8,15,22,23,24;30,29,28,21,14,7,0,1,2,3,4;42,35,36,37,38,39,40,33
7,0,38,6;16,23,30;8,9,10,17,24,31,32,39;40,33,26,25,18;13,6,5;46,47,48,41,34,27,20,19,12,11,4,3,2,1,0,7,14,15,22,29,36,37,38;21,28,35,42,43,44,45
7,0,39,7;0,1,8,15,22,29,36,37,38,39,40;23,16,17,18;7,14,21,28,35,42,43,44,45,46,47;12,11,10;48,41,34,33,32,31,30;9,2,3,4,5,6,13,20,19;27,26,25,24
7,0,40,5;15,8,9,10,11,12,19,26,33,40;30,31,24;23,22,21,14,7,0,1,2,3,4,5,6,13,20,27,34,41,48,47;16,17,18,25,32,39,38,37,36,29,28;46,45,44,43,42,35
7,0,41,7;15,8,1;13,12,19,26,33,32,31,30;3,10,17;20,27,34,41,48,47,46,45,44,43,42,35,28;40,39,38,37,36,29,22,21;6,5,4,11,18,25,24,23,16,9,2;14,7,0
7,0,42,5;37,36,29,22,15,8,9,2,3,4,5,6,13,20,27,34,41,48,47,46,45;32,31,38;30,23,24,25,18;16,17,10,11,12,19,26,33,40,39;44,43,42,35,28,21,14,7,0,1
7,0,43,5;22,23,24,25,18;33,26,19,12,11,10,9,8;29,30,31,32;36,37,38,39,40,41,34,27,20,13,6,5,4,3,2,1,0,7;48,47,46,45,44,43,42,35,28,21,14,15,16,17
7,0,44,5;25,18,11,4,5,6,13,20,27,34,41,48,47,46,45,44,43,42,35,28,21,14;12,19,26,33;40,39,38,37,30,23,16,9,8,7;0,1,2,3,10,17,24,31,32;36,29,22,15
7,0,45,6;17,16,23,30,29,28,35,42;12,19,26,33,34;41,40,39,32,25,18,11,10,9,8,15,22;27,20,13,6,5,4,3,2,1,0,7,14,21;36,43,44,45,46,47,48;37,38,31,24
7,0,46,7;19,18,11,4,5;8,15,22,29,36,37;6,13,12;38,39,40,41,34;9,16,23,30,31,32,33;20,27,26,25,24,17,10,3,2;1,0,7,14,21,28,35,42,43,44,45,46,47,48
7,0,47,6;19,12,11,10,9,8,15;14,21,28,35,42,43,44,45,46,47,48,41,34;18,17,16;22,29,36,37,38,39,40;23,24,25,26,27,20,13,6,5,4,3,2,1,0,7;30,31,32,33
7,0,48,7;7,0,1,2,3,4,5,6,13;42,35,36,29,22;48,47,46,45,44,43;41,40,33,26,25,18;17,24,31,32,39;8,9,10,11,12,19,20,27,34;28,21,14,15,16,23,30,37,38
7,0,49,5;16,15,8,1;5,6,13,20,27,34,41,48,47,46,45,44,37,30,31,32,25,18;38,39,40,33,26,19,12,11,4,3;42,35,28,21,14,7,0;43,36,29,22,23,24,17,10,9,2
7,0,50,7;17,16,15,8;29,30,31,32,25,18,19;42,35,28,21;37,38,39,40,33,26;36,43,44,45,46,47,48,41,34,27,20,13,6,5,4,3,2,1,0,7,14;24,23,22;12,11,10,9
7,0,51,4;35,42,43,44,45,46,47,40,33,26,19,12,11,10,9,8,15;24,31,30,29,28;48,41,34,27,20,13,6,5,4,3,2,1,0,7,14,21;36,37,38,39,32,25,18,17,16,23,22
7,0,52,7;11,4,5,6,13,20,27,34,33,32;9,16,17,18;31,24,25,26,19,12;30,23,22,15,8;43,42,35,28,21,14,7,0,1,2,3,10;48,47,46,45,44,37,36,29;41,40,39,38
7,0,53,6;30,31,32;15,14,21,28,35,36,37,38,39,40,33,26,19,12;42,43,44,45,46,47,48,41,34,27,20,13,6,5,4,3,10,17;0,7,8;16,9,2,1;29,22,23,24,25,18,11
7,0,54,4;36,29,22,15,8,9,10,11,12,19,26,33;48,47,46,45,38;25,18,17,16,23,30,37,44,43,42,35,28,21,14,7,0,1,2,3,4,5,6,13,20,27;34,41,40,39,32,31,24
7,0,55,6;4,5,12,19,26;23,30,37;0,1,2,3;22,29,36,43,44,45,46,47,48,41,34,27,20,13,6;7,8,9,10,11,18,25,32;33,40,39,38,31,24,17,16,15,14,21,28,35,42
7,0,56,6;21,28,35,36,37,38,39,40,41,34,27,26,25;33,32,31,30,29;18,19,20,13,6,5,4,3,2,1,0,7,14,15,22,23;24,17,10,11,12;48,47,46,45,44,43,42;16,9,8
7,0,57,7;41,48,47,46,45;36,29,22,15,8,9,10,11,12,19,20;42,35,28,21,14,7,0,1,2,3,4,5,6,13;32,33,40;43,44,37,38,39;24,25,26,27,34;18,17,16,23,30,31
7,0,58,6;16,17,18,19;43,44,45,46,47,40,33,26,25,24,23,22,21,14,7,0,1;12,11,10;36,37,38;15,8,9,2,3,4,5,6,13,20,27,34,41,48;42,35,28,29,30,31,32,39
7,0,59,6;48,47,46,45,44;14,7,0,1,2,3,4,5,6,13,20,27,34,41,40,39,38,37,36;10,17,16;15,8,9;18,25,24,23,22,21;43,42,35,28,29,30,31,32,33,26,19,12,11
7,0,60,5;40,33,26,19,12,11,10,17,24;9,16,23,30,31,38,45,46,47,48;0,7,14,21,28,35,42,43,44;41,34,27,20,13,6,5,4,3,2,1,8,15,22,29,36,37;18,25,32,39
7,0,61,5;40,39,38,37,36;13,6,5,4,3,2,1,0,7,14,21,28,35,42,43,44,45,46,47,48,41,34,27,26,25,24,23;33,32,31,30,29,22,15,8,9,10,11;16,17,18;12,19,20
7,0,62,6;48,47,46,45,44;24,23,30,37,38,39,40,41;43,42,35,28,21,14,7,0,1,2,3,4,5,6,13,20,27,34;33,32,31;36,29,22,15,16,17,18;25,26,19,12,11,10,9,8
7,0,63,7;6,5,4,3,2,1,0,7,14,21,28,35,42,43,44,45,46,47;37,30,23,24,25,26;19,18,17,16;34,27,20,13,12;31,32,33;38,39,40,41,48;11,10,9,8,15,22,29,36
7,0,64,5;30,31,32,25,18;21,28,35,42,43,44,45,46,47,48,41,34,27,20,13,6,5;24,17,10,9,8;16,23,22,29,36,37,38,39,40,33,26,19;12,11,4,3,2,1,0,7,14,15
7,0,65,7;40,33,26,25,24,17,16,15,14,7,0;44,45,38;9,10,11,4,5,6,13,20,27,34,41,48,47,46,39,32,31,30,23;8,1,2,3;21,28,35,42,43;22,29,36,37;12,19,18
7,0,66,6;19,12,11,10,9,8;37,30,23,16,17,18,25;40,39,38;21,28,29,36;35,42,43,44,45,46,47,48,41,34,33,32,31,24;26,27,20,13,6,5,4,3,2,1,0,7,14,15,22
7,0,67,7;4,5,6,13,20,27,34,41,48;23,22,21,28,35,42;45,46,39,32,25,26,19,12,11,10,3,2,1,0,7,14,15;43,36,29,30,31,24,17,18;33,40,47;16,9,8;44,37,38
7,0,68,6;24,31,32,33;6,5,4,11;13,12,19;10,3,2,1,0,7,14,21,28,35,42,43,44,45,46,47,48,41,34;40,39,38,37,36,29,22,15,8,9;30,23,16,17,18,25,26,27,20
7,0,69,5;28,35,42,43,44,45,38,39,40,33,26,19,12,11,4,3,2;46,47,48,41,34,27,20,13,6,5;15,16,23,24;7,14,21,22,29,36;0,1,8,9,10,17,18,25,32,31,30,37
7,0,70,5;21,28,35,42,43,44,45,46,47,48,41,34,27,20,13,6,5,4,11,18,25,24,23;32,31,30;17,16,9,8;12,19,26,33,40,39,38,37,36,29,22,15,14,7,0;1,2,3,10
7,0,71,6;2,1,0,7,14,21,28,29,36;35,42,43,44,37,38,39,40;10,17,16;24,25,18,11,4,3;45,46,47,48,41,34,27,20,13,6;9,8,15,22,23,30,31,32,33,26,19,12,5
7,0,72,6;40,33,26;8,15,22,29,36,37,38,39,32,25,18,19;31,24,17,10,9;30,23,16;13,6,5;12,11,4,3,2,1,0,7,14,21,28,35,42,43,44,45,46,47,48,41,34,27,20
7,0,73,6;48,41,40;14,7,0,1,2,3,4,5,12,19,18,17,16,23,30;37,36,29,22,15,8,9,10,11;43,42,35,28,21;44,45,38,31,24,25,26,27,20,13,6;34,33,32,39,46,47
7,0,74,7;18,17,16,15,22;25,24,23,30,29;19,12,11,10,9,8;38,39,40,41,34,27,20,13,6,5,4,3,2,1,0,7;26,33,32,31;42,43,44,45,46,47,48;14,21,28,35,36,37
7,0,75,6;46,47,48,41,34;20,13,6,5,4,3,2,1,8,15,22,29,36;39,40,33;19,12,11,10,9,16,23,30,37;27,26,25,32,31,38,45,44,43,42,35,28,21,14,7,0;18,17,24
7,0,76,5;12,11,10,9,8;48,47,40,33,26,25;21,22,29,36,37,38;30,23,16,15,14,7,0,1,2,3,4,5,6,13,20,27,34,41;19,18,17,24,31,32,39,46,45,44,43,42,35,28
7,0,77,6;0,7,14,21;36,37,38,45,46,47,40,33;20,13,6,5,4,3,2,1,8,15,22,29,28,35,42,43,44;39,32,25;48,41,34,27,26,19,12,11,10,9,16,23,30;31,24,17,18
7,0,78,5;6,13,12,19,26,33,40,47,46,45,44,43,42,35,28;16,17,24,25,32,39,38,37,36,29;20,27,34,41,48;18,11,10,9,8,15;31,30,23,22,21,14,7,0,1,2,3,4,5
7,0,79,6;22,29,36,43;24,31,30,37,44;40,33,26,19,12,11,10,9,8;42,35,28,21,14,15,16,23;38,45,46,47,48,41,34,27,20,13,6,5,4,3,2,1,0,7;39,32,25,18,17
7,0,80,5;11,10,9,8,15,22,29,36,37,38;6,13,20,19,18,17,16,23,30,31,32;41,48,47,46,45,44,43,42,35,28,21,14,7,0,1,2,3,4,5,12;39,40,33,34;27,26,25,24
7,0,81,5;7,0,1,2,3,4,5,6,13,20,27,34,41,48,47,46,45,38,31;19,12,11,10,9,8;36,29,22,23,24;33,26,25,18,17,16,15,14,21,28,35,42,43,44,37,30;32,39,40
7,0,82,6;0,7,14,21,28,35,42,43,44,45,46,47;19,18,17,16,15,8,1;40,39,38,37,36,29,22,23,24,25,26,27,20,13,6;11,10,9;48,41,34,33,32,31,30;2,3,4,5,12
7,0,83,5;44,45,46;24,31,32,39;40,33,26,19,12,11,10,9,8,15,22,29,36,37,38;25,18,17,16,23,30;47,48,41,34,27,20,13,6,5,4,3,2,1,0,7,14,21,28,35,42,43
7,0,84,7;8,15,14,21,28,35,36;42,43,44,45,46,47,48,41,34;38,31,32,25,26,19,12,11,10,9,16,23;18,17,24;27,20,13,6,5,4,3,2,1,0,7;22,29,30,37;39,40,33
7,0,85,6;28,35,42,43,44,45,46,47,48,41,34,27,20,13,6;40,33,26,19,12,5;21,22,29,36;38,39,32,25,18,11,4,3,2,1;0,7,14,15,16,23,30,37;31,24,17,10,9,8
7,0,86,6;32,33,34,41,48,47,46,45,44,43,42,35,28,29,22,15,8,1,2,3,4;40,39,38,37,36;25,26,27,20,13,6,5;11,10,9,16,23,30;0,7,14,21;12,19,18,17,24,31
7,0,87,6;26,25,18,11,10;23,30,37,38,39,40;9,8,15,22,29,36,35;16,17,24,31,32,33;42,43,44,45,46,47,48,41,34,27,20,13,6;19,12,5,4,3,2,1,0,7,14,21,28
7,0,88,5;16,17,18,11,4,3;5,12,19,26,33,40,39,38,37,36,29,22,23,24;10,9,8,15,14,21,28,35,42,43,44,45,46,47,48,41,34,27,20,13,6;2,1,0,7;25,32,31,30
7,0,89,4;12,19,26,33,40,39,38,37,36,29;24,17,16,15,8;14,21,28,35,42,43,44,45,46,47,48,41,34,27,20,13,6,5,4,3;22,23,30,31,32,25,18,11,10,9,2,1,0,7
7,0,90,6;24,17,10,9,8,1;2,3,4,5,6,13,20,27,34,41,48,47,46,45,44,43,42,35,28,21;40,39,38,37,36,29,22;15,16,23,30,31,32,25,18,11;12,19,26,33;14,7,0
7,0,91,6;40,33,26,19,12,11;29,30,31,24;4,5,6,13,20,27,34,41,48,47,46,45,44,43,42,35;0,7,14,15;28,21,22,23,16,9,8,1;36,37,38,39,32,25,18,17,10,3,2
7,0,92,8;6,13,20,27,34;10,17,24,31;28,21,14,7,0,1,2,3,4,11,18,25,26,33,40,41;32,39,38;36,37,30,23,16,9;5,12,19;48,47,46,45,44,43,42,35;29,22,15,8
7,0,93,8;17,18,11,12,13,6;44,45,46,47,48,41,34,27,20,19;9,16,23,24;43,42,35,28,21,14,7,0,1,2;26,33,40,39,38;36,37,30,31,32,25;29,22,15,8;10,3,4,5
7,0,94,6;30,23,16;34,41,48,47,46,39,38,31,24;40,33,32,25,18,17;45,44,43,42,35,28,21,14,7,0,1,2,3,4,5,6,13,20,27,26;37,36,29,22,15,8,9;10,11,12,19
7,0,95,5;18,25,32,31,30,23,22;2,3,4,5,6,13,20,27,34,41,48,47,46,45,44,43,42,35,28,21;14,7,0,1;8,15,16,17,24;9,10,11,12,19,26,33,40,39,38,37,36,29
7,0,96,4;13,12,11,10,9,8;6,5,4,3,2,1,0,7,14,15,16,17,18,19,20,27,34,41,48,47,46,45,44,43,42,35;24,25,26,33,40,39,38,37,36,29,28;21,22,23,30,31,32
7,0,97,7;5,6,13;31,24,25,18;40,47,48;3,4,11,12,19,20,27,34,41;26,33,32,39,46,45,44,43,42,35,28,21,14,7,0,1,2;10,17,16,23,30,37,38;9,8,15,22,29,36
7,0,98,6;14,7,8,9,10;26,19,12,11;0,1,2,3,4,5,6,13,20,27,34,33,32,25,18;23,30,37;21,28,35,42,43,44,45,46,47,48;36,29,22,15,16,17,24,31,38,39,40,41
7,0,99,6;6,13,12,19;0,7,8,9,10,11,18,25,26,27,20;1,2,3,4,5;30,31,32,33,34;23,22,29,36,37,38,39,40;41,48,47,46,45,44,43,42,35,28,21,14,15,16,17,24
7,0,100,5;8,9,16,17;24,31,30,29;40,33,26,19,12;23,22,21,28,35,42,43,44,45,46,47,48,41,34,27,20,13,6,5,4;36,37,38,39,32,25,18,11,10,3,2,1,0,7,14,15
7,0,101,6;27,26,19;30,23,16,9,10,3;17,24,31,38,37,36,29,22,15,8;4,5,6;2,1,0,7,14,21,28,35,42,43,44,45,46,47,48,41,34,33;40,39,32,25,18,11,12,13,20
7,0,102,7;3,4,5,6,13,20,27,34,41,48,47,46;23,24,17,10,11,12,19,26,33,40,39;31,32,25,18;16,9,2,1,0;15,22,29,28,35,42,43,44,45,38;21,14,7,8;36,37,30
7,0,103,7;8,15,16,23,30;7,0,1,2,9,10,17,24,31;48,47,46,45,44,43,42,35,28,21,14;39,38,37,36,29,22;3,4,11,18,25,32;5,12,19,26,33,40;41,34,27,20,13,6
7,0,104,7;40,33,26,19,12,5,4,3,2,1,0,7,14,21;9,16,17;36,37,30;46,47,48,41,34,27,20,13,6;45,38,39,32,25,18,11,10;29,28,35,42,43,44;31,24,23,22,15,8
7,0,105,7;35,36,29;8,9,10,11;24,17,18,19,12,5;6,13,20,27,34,33,40,39;26,25,32,31,38,45,46,47,48,41;42,43,44,37,30,23,16,15,14,7,0,1,2,3,4;28,21,22
7,0,106,7;15,16,17,18;25,26,27;36,37,38,39,40;20,13,6,5,4,3,2,1,0,7,14,21,22,23;24,31,32,33,34,41,48,47,46,45,44,43;19,12,11,10,9,8;30,29,28,35,42
7,0,107,5;8,9,16;18,11,4,5,6,13,20,27,34,33,40,39,38,37,36,29;30,31,32,25,26,19,12;41,48,47,46,45,44,43,42,35,28,21,14,7;0,1,2,3,10,17,24,23,22,15
7,0,108,6;30,37,36,35,28,21,14,7,0,1,2,3,4,5,6,13,20,19,26,33,40;25,18,17,16;42,43,44,45;32,31,24,23;12,11,10,9,8,15,22,29;38,39,46,47,48,41,34,27
7,0,109,6;11,10,9,16,23,22,29;40,33,26,25;46,47,48,41,34,27,20,13,6,5,4,3,2,1,0,7;43,44,45,38,39,32;8,15,14,21,28;42,35,36,37,30,31,24,17,18,19,12
7,0,110,7;44,43,42,35,28,21;27,20,13,6,5,4,3,2,9,8,15,22,29,36;48,41,34,33,26,19,12,11,10;37,30,23,16;47,46,45,38,31,24;1,0,7,14;17,18,25,32,39,40
7,0,111,4;32,33,34,27,20,13,6;40,39,38,37,36,29,22,23,16,17,18,11,4,3,2,1,0,7;41,48,47,46,45,44,43,42,35,28,21,14,15,8,9,10;5,12,19,26,25,24,31,30
7,0,112,6;40,33,26,19,12,5;14,15,8,9,10,17,24;16,23,22,21,28,35,42;29,30,31,32,25,18,11,4,3,2,1,0,7;43,36,37,38,39;44,45,46,47,48,41,34,27,20,13,6
7,0,113,6;30,37,36;41,48,47,46,39,32;45,44,43,42,35,28,29,22,23,16,17,18;10,9,8,15,14,21;5,6,13,20,27,34,33,40;38,31,24,25,26,19,12,11,4,3,2,1,0,7
7,0,114,4;10,17,24;1,8,9,16,23,30,31,32,25,18,11,12,13,20,27,34,41,48,47,46,45,44,43,42,35,28,21;19,26,33,40,39,38,37,36,29,22,15,14,7,0;2,3,4,5,6
7,0,115,6;15,22,29,36,37,38,31,24,17,10,11,12,19,26;0,1,8,9,16,23,30;33,32,25,18;40,39,46,45,44,43,42,35,28,21,14,7;2,3,4,5,6,13,20,27,34;41,48,47
7,0,116,5;23,30,31,32,25;8,9,10,11;24,17,18,19,12,5,4,3,2,1,0,7,14,21,28,35,42,43,44,45,46,47,48,41,34,33;26,27,20,13,6;40,39,38,37,36,29,22,15,16
7,0,117,4;24,23,22,15,8,9,2,3,4,5,6,13,20,27,34,41,48,47,46;1,0,7,14,21,28,29,36;18,25,32,31,30,37;16,17,10,11,12,19,26,33,40,39,38,45,44,43,42,35
7,0,118,5;24,23,22,15,8,1,0;29,36,37,38,39,40,33,26,19,12;7,14,21,28,35,42,43,44;45,46,47,48,41,34,27,20,13,6,5,4,3,2,9,16,17;10,11,18,25,32,31,30
7,0,119,7;20,27,34,41,48,47,46,45,44,43;8,15,16;1,0,7,14,21,22,29,30,31,32,25,18,19;9,2,3,4,5,6;42,35,28;26,33,40,39,38,37,36;13,12,11,10,17,24,23
7,0,120,6;19,20,13,6,5,4,3,2,1,0,7,14,21;36,37,38,31,24,17,10;18,11,12;39,40,33;30,23,16;9,8,15,22,29,28,35,42,43,44,45,46,47,48,41,34,27,26,25,32
7,0,121,7;9,16,23,24;42,35,36;19,26,33,40,39,38,37,30,29,28;22,15,8,1,2,3,10,17,18,25,32,31;43,44,45,46,47,48,41,34,27,20,13,6,5;0,7,14,21;12,11,4
7,0,122,7;1,2,9,16,23,30,31,38;32,39,40,41,34,27,20;18,19,26,33;13,12,11,10,17,24,25;6,5,4,3;0,7,8,15,22,29,36,37;14,21,28,35,42,43,44,45,46,47,48
7,0,123,5;4,5,6,13,20,27,34,41,48,47,46,45,44,43,42,35,28,21,22;19,18,17,16,9,8;15,14,7,0,1,2,3,10,11,12;29,36,37,38,39,40,33,26,25,24,23;32,31,30
7,0,124,6;29,36,37,44,45,46,39,32;48,47,40,33,26,19,12;43,42,35,28;41,34,27,20,13,6,5,4,3,2,1,0,7,14,21,22,23,30,31,38;15,16,17,24;8,9,10,11,18,25
7,0,125,7;27,26,25,18,17,10,3,4,5,6,13;41,34,33,32,31,24,23,16,9,2;40,47,48;36,43,44,45,46,39;1,8,15,22,29,30,37,38;20,19,12,11;0,7,14,21,28,35,42
7,0,126,6;26,33,40,47,48;46,45,38,31,24,23,16,9;39,32,25,18,17,10;19,12,11;8,15,22,29,30,37,44,43,42;41,34,27,20,13,6,5,4,3,2,1,0,7,14,21,28,35,36
7,0,127,5;36,37,38,39,40,33,26,19,12,11;2,1,0,7,14,21;25,18,17,10,3,4,5,6,13,20,27,34,41,48,47,46,45,44,43,42,35,28;9,16,23,24,31,32;30,29,22,15,8
7,0,128,7;25,32,33,40,47;48,41,34,27,20,13,6,5,4,3,2,1,0,7,14,21,28;26,19,12,11,10,9,8,15,22,29;42,43,44,45,46,39;16,17,18;35,36,37,30,23;38,31,24
7,0,129,5;37,38,39,32,25,18,17,16;31,30,29,36,43,44,45,46,47,40,33,26,19,12,11,10;24,23,22,15;42,35,28,21,14,7,0,1;48,41,34,27,20,13,6,5,4,3,2,9,8
7,0,130,4;38,39,40,41,34,27,20,13,6,5,4,3,2,1;12,19,26,33,32,31,30,37,44,45,46,47,48;0,7,8,9,10,11,18,25,24,23,22,29,36,43,42;35,28,21,14,15,16,17
7,0,131,6;19,26,33,32,31,30,29;40,39,38,37,36;16,17,18,11,12,13,6;20,27,34,41,48,47,46,45,44,43;5,4,3,10,9,8,15,22,23,24,25;42,35,28,21,14,7,0,1,2
7,0,132,8;13,6,5,4,11,18,25,24;42,35,36,37,38,39,40,41,34,27,20;8,1,2,3;22,15,16;0,7,14,21,28,29,30,23;17,10,9;43,44,45,46,47,48;31,32,33,26,19,12
7,0,133,6;48,41,40,39,38,37,30,23;9,16,17,24,25,26,19,12;0,1,2,3,10,11,18;47,46,45,44,43,36,29,22,15,8,7;14,21,28,35,42;4,5,6,13,20,27,34,33,32,31
7,0,134,5;18,25,32,39,38,37,36;22,23,16,9;29,30,31,24,17,10,11,12,19,26,33,40;3,4,5,6,13,20,27,34,41,48,47,46,45,44,43,42,35,28,21,14,7,0;2,1,8,15
7,0,135,7;0,1,2;48,41,34,27,20,13,6;25,18,11,4;15,14,21,28,35,42;3,10,17,24,31,30,37;5,12,19,26,33,32,39,38;7,8,9,16,23,22,29,36,43,44,45,46,47,40
7,0,136,5;45,46,47,48,41,34,27,20,13,6,5,4,3,2,1,0,7,14,21,28,35,42,43;33,32,25,18,17,16,23,22,29,36,37,44;38,39,40;24,31,30;26,19,12,11,10,9,8,15
7,0,137,5;16,17,18,19,12;30,23,22,15,8,9,10,11;48,41,34,27,20,13,6,5;31,24,25,26,33,40,47,46,45,44,43,42,35;4,3,2,1,0,7,14,21,28,29,36,37,38,39,32
7,0,138,6;32,31,38,37,36,29,22,15,16,17,18,11;25,24,23,30;39,40,33,26,19,12;0,1,2,3,4,5,6,13,20,27,34,41,48,47,46;10,9,8,7,14,21;28,35,42,43,44,45
7,0,139,6;35,28,21,14,15,16;4,3,2,1,0;26,33,40,39,38;25,32,31,30,37,44,45,46,47,48,41,34,27,20,13,6,5;42,43,36,29,22,23,24,17,18,19,12;11,10,9,8,7
7,0,140,6;18,17,16;22,15,8,9,10;5,6,13,20,27,34,41,48,47,46,45;32,25,24,23,30,29,36;4,11,12,19,26,33,40,39;31,38,37,44,43,42,35,28,21,14,7,0,1,2,3
7,0,141,6;30,29,28,35,42,43,44,45,46,47;5,6,13,20,27;36,37,38,31,24,17,16,15;48,41,34,33,26,19,12,11,4,3,2,1,0,7,14,21,22,23;40,39,32,25,18;10,9,8
7,0,142,6;35,42,43,44,45,46,39,32;36,37,38,31,24;19,12,11,10,9;0,7,14;40,33,26,25,18,17,16,23,30,29;47,48,41,34,27,20,13,6,5,4,3,2,1,8,15,22,21,28
7,0,143,7;27,26,25,32,31,30,23,16,9,10,11,12,13;1,2,3,4,5,6;41,48,47;0,7,8,15;20,19,18,17,24;38,37,36,29,22;34,33,40,39,46,45,44,43,42,35,28,21,14
7,0,144,6;6,13,20,27,26,25,24,23,30;22,15,8,9,10,11,12,5;40,39,38,37,36,29;16,17,18,19;44,43,42,35,28,21,14,7,0,1,2,3,4;45,46,47,48,41,34,33,32,31
7,0,145,6;18,17,16,23,30,37;19,12,11,10,9,8,15,22,29,36,43,44,45,46,39;42,35,28,21,14,7,0,1,2,3,4,5,6,13,20,27,26;40,47,48;41,34,33,32;25,24,31,38
7,0,146,6;12,19,26;47,46,45,44,43,42,35,28,21,14,7,0,1,2,3,4;5,6,13,20,27;37,36,29,22,15,8,9,10,11;24,25,32,33,34,41,48;40,39,38,31,30,23,16,17,18
7,0,147,5;4,3,2,1,0,7,14,21,28,35,42,43,44,45,46,47,48,41;6,13,20,19,18,17;32,31,30,23,16;24,25,26;27,34,33,40,39,38,37,36,29,22,15,8,9,10,11,12,5
7,0,148,5;6,5,12,11,10,9,8,15,22;4,3,2,1,0,7,14,21,28,35,42,43,44,37,38,31,32,33,40,47;13,20,19,18,17,16;45,46,39;36,29,30,23,24,25,26,27,34,41,48
7,0,149,6;30,29,28;15,8,9;40,39,38,37,36,35,42;43,44,45,46,47,48,41,34,27,20,13,6,5,4,11,18,25;21,14,7,0,1,2,3,10,17,16;22,23,24,31,32,33,26,19,12
7,0,150,6;42,35,28,21,22,23,24;14,15,16,17,18,25,32,33,34,27;0,1,2,3,4,5,6,13,20;41,48,47,46,45,44,37;40,39,38,31,30,29,36,43;7,8,9,10,11,12,19,26
