5,0,1,4;0,1,6,11,16;23,24,19,14,9,4;3,2,7,12,17,22,21,20,15,10,5;18,13,8
6,0,2,5;22,16,10,9;1,0,6,12;14,15,21,27,28;31,25,26,20;32,33,34,35,29,23,17,11,5,4,3,2,8,7,13,19,18,24,30
7,0,3,7;42,35,28,21,14,15,8;30,37,44;43,36,29,22,23,16;48,41,40,39,32,25,18,17;7,0,1,2,3,4,5,6,13,20,27;47,46,45,38,31,24;9,10,11,12,19,26,33,34
8,0,4,7;25,33,41,49;52,53,54;0,8,16;17,18,10,11,12,13,14,22,30,29,37;19,20,21;24,32,40,48,56,57,58,50,42,34,26,27,28,36,44,45,46,38,39,31,23,15,7,6,5,4,3,2,1,9;47,55,63,62,61,60,59,51,43,35
9,0,5,9;66,57,48,47,38,29,28,27,36,45,54;63,72,73,74,75,76,77,68,59,50,41,32,33,24,15,16;14,13,12,11,10;31,22,23;64,65,56;80,71,62;67,58,49,40,39,30,21,20,19,18,9,0,1,2,3,4,5,6,7,8,17,26,35,44,53,52,61,70,79,78;55,46,37;25,34,43,42,51,60,69
8,0,6,7;0,8,16,24,25;28,36,44,52,51,50;10,11,19,27,35,43,42,41,49,57;62,63,55,47;54,46,38,39,31,23,15,7,6,5,13,21,20;56,48,40,32,33,34,26,18,17,9,1,2,3,4,12;14,22,30,29,37,45,53,61,60,59,58
7,0,7,7;45,46,47,48,41,34,27,20,13,6;44,43,42,35,28,21,14;9,16,23,30;10,17,24,31,38,37,36,29,22,15,8,7;0,1,2,3,4,11,18,25,32,39;26,33,40;5,12,19
6,0,8,6;31,25,26,27;12,13,14,15,16,22,28,34,33,32;21,20,19,18,24,30;7,8,9,10;2,1,0,6;35,29,23,17,11,5,4,3
5,0,9,4;4,3,8,7,6,11,16;2,1,0,5,10,15,20,21,22,23,24;17,18,19;12,13,14,9
6,0,10,5;35,29,28,22,16,10;7,8,14,20;26,25,19,13,12,6,0,1,2;32,31,30,24,18;34,33,27,21,15,9,3,4,5,11,17,23
7,0,11,5;13,12,11,18,25,32,39,38,37;36,29,30,31,24,17,10,3,4,5,6;48,41,34,27;23,16,9,2,1,0,7,14,21,28,35,42,43,44,45,46,47,40,33,26,19,20;8,15,22
8,0,12,8;53,52,51,50,42,34;22,23,31,39,47,55,63,62,61,60,59,58,57,56,48,40;44,43,35,27,26,25;19,11,10,2,1,0,8,16,24,32,33,41,49;18,17,9;7,15,14,13,12,20,28,36,37,45,46,54;6,5,4,3;21,29,30,38
9,0,13,7;4,13,12,11,10,19,28,37,46,55,64,65,66,57,48,39;5,14,23,22,21,20,29,38,47,56;8,17,26,35,44,53,62,71,80,79,78,77,76,75,74,73,72,63,54,45,36,27,18,9,0,1,2,3;59,58,49,40,31,30;6,15,24,33,42,43,52,61,70,69,68,67;7,16,25,34;32,41,50,51,60
8,0,14,6;12,13,21;34,42,43,44,45,46;7,15,23,31,39,47,55,63,62,61,60,59,58,57,56,48,40,32,24,16,8,0,1,2,10,18,19,20;26,27,35,36,37,38;11,3,4,5,6,14,22,30,29,28;54,53,52,51,50,49,41,33,25,17,9
7,0,15,7;3,2,1,8,15,22;10,9,16,23,30,29,28;42,43,44,45,46,47,48,41,34,27,26,25,18,11,4,5,6,13;20,19,12;0,7,14,21;17,24,31,32,33;35,36,37,38,39,40
6,0,16,7;35,34,28;30,31,32,33;10,11,17,23,29;21,27,26,25,24;12,13,7,8,9,15,16,22;14,20,19,18;5,4,3,2,1,0,6
5,0,17,4;8,13,12;7,6,11,16,17,18,23;24,19,14;9,4,3,2,1,0,5,10,15,20,21,22
6,0,18,5;4,5,11,17,23;13,12,6,0,1,2,3,9,10,16,22;31,30,24,18,19,20;7,8,14,15,21,27,28,29;35,34,33,32,26,25
7,0,19,6;1,0,7,14,21;28,29,22,15,8,9,10,11,12,19,26,27,34,41,48,47;39,38,31,24;20,13,6,5,4,3,2;35,42,43,44,45,46;40,33,32,25,18,17,16,23,30,37,36
8,0,20,7;60,61,62,63,55,47,39,31,23,15,7,6,5,4,3,2,1,0,8,16,24,32,40,48,56,57,58;54,53,52,51,59;49,41,33,34,35,36;28,27,26,18,10;50,42,43,44,45,46,38,30,22,14,13,12,11;37,29,21,20,19;9,17,25
9,0,21,8;13,14,15,16,25,26,35,44,53,62,61,70,69,68,67;71,80,79,78,77,76,75,66;40,31,22,23,24;32,33,34,43,52,51,60,59,58,57,56,47,38,37,28,19,10;42,41,50,49,48;29,20,11,2,1,0,9,18,27,36,45,54,63,72,73;17,8,7,6,5,4,3,12,21,30,39;46,55,64,65,74
8,0,22,8;36,44,52,53,54;30,22,14,6,5,4,3,2,1,0;56,48,49,50,42,34,26,27,28;32,24,16,8,9,10,11,12,13;18,17,25,33,41,40;38,39,31,23,15,7;35,43,51,59,58,57;60,61,62,63,55,47,46,45,37,29,21,20,19
7,0,23,5;24,17,18,11,12;33,40,39,38,37;35,28,21,14,7,0,1,2,3,4,5,6,13,20,27,34,41,48,47,46,45,44;19,26,25,32,31,30,23,16;10,9,8,15,22,29,36,43,42
6,0,24,5;25,26,27,28;1,7,13,19,20,21,22,16;0,6,12,18,24,30,31,32,33,34,35,29,23,17,11,5,4;3,2,8;10,9,15,14
5,0,25,4;21,22,23,18,13,8,3,2,1,0,5,10,11;16,15,20;17,12,7,6;24,19,14,9,4
6,0,26,4;10,16,22,28,34,33;35,29,23,17,11,5,4,3,2,1,7,13,19,25;0,6,12,18,24,30,31,32,26,20,14,8;9,15,21,27
7,0,27,5;18,25,32,39,46,47,48,41,34,27,20,13,6,5,4,3,2,1,0,7,14,21,28,35,42,43;15,22,29,36,37;16,23,30;17,24,31,38,45,44;40,33,26,19,12,11,10,9,8
8,0,28,7;18,10,2,3,4,5,6,7,15,23,31,39,47,55,63,62,61,60,52,44;21,20,28,36,35,34,42,50,49;1,9,17,25,26,27,19,11,12;41,33,32,24,16,8,0;13,14,22,30,38,46,54;43,51,59,58,57,56,48,40;29,37,45,53
9,0,29,7;54,63,72,73,74,65,66,67,68,69,60,51,42,33,32,31,22;16,15,14,13,12,21,30,39;70,61,52,43,34,25,24,23;37,38,29,20,11;41,50,59,58,57,56,55,64;75,76,77,78,79,80,71,62,53,44,35,26,17,8,7,6,5,4,3,2,1,0,9,18;40,49,48,47,46,45,36,27,28,19,10
8,0,30,7;48,56,57,58,59,60,61,62,63,55,47,39,31,23,15,7,6,5,4;19,18,10;13,21,29,28,27,26,25;35,36,37,45;8,0,1,2,3,11,12,20;9,17,16,24,32,40,41,49,50,51;33,34,42,43,44,52,53,54,46,38,30,22,14
7,0,31,6;11,4,5,6,13,20,27;33,34,41,48,47,46,45,38,31,30,29,22,15;40,39,32,25,26,19,12;24,23,16,9,8,7,14,21,28,35,42,43;36,37,44;18,17,10,3,2,1,0
6,0,32,5;6,0,1,2,3,4,5,11,17,23,29,35,34,33;15,21,27,26,32,31,30;19,20,14;16,22,28;25,24,18,12,13,7,8,9,10
5,0,33,5;20,21,22,17,12;4,9,14,19,24,23;18,13,8,3;7,6,11,16;2,1,0,5,10,15
6,0,34,6;24,30,31,32,33,34,35,29,23,17,11,5;9,15,16,22;2,8,14,20,21;18,12,6,0;1,7,13,19,25,26,27,28;3,4,10
7,0,35,5;24,31,32,33,34;36,29,22,15,8;26,19,12,11,10,9,16,23,30,37,38,39,40,41,48;47,46,45,44,43,42,35,28,21,14,7,0,1,2,3,4,5,6,13,20,27;25,18,17
8,0,36,8;44,36,37,29,21,13,14;57,56,48,40,32,24,16,8,0,1,2,3;55,54,53,52,51,43,35,27,28,20;34,42,50,58,59,60,61,62,63;19,11,12,4,5,6,7,15,23,31,39,47;22,30,38,46,45;26,18,10,9;49,41,33,25,17
9,0,37,7;33,42,41,50,59,68,77,76,75,74,73,72,63,54,45;12,11,10,19,28;27,18,9,0,1,2,3,4,5,6,7,8,17,26,35,44,53,62,61,70;29,20,21,22,13,14,15,16;38,47,56;67,58,49,40,31,32,23,24,25,34,43,52,51,60,69,78,79,80,71;30,39,48,57,66,65,64,55,46,37,36
8,0,38,9;56,48,49,41,42;15,7,6,5,13,21,29,30;44,36,28;61,62,54,46,38;57,58,50,51,43,35,27,19,20,12,4,3,2,1,0,8,16,24,32,40;59,60,52,53,45,37;63,55,47,39,31,23,22,14;11,10,9,17,25;18,26,34,33
7,0,39,7;13,6,5,4,3,2,1,0,7,14,21,28,35,42,43;26,25,18,17,16,15;8,9,10,11,12,19,20,27,34;47,46,39;45,44,37,36,29,22,23,24;32,33,40,41,48;38,31,30
6,0,40,4;13,14,15,16,17,11,5,4,3,2,1,0;24,18,12,6,7,8,9,10;28,27,26,25;30,31,32,33,34,35,29,23,22,21,20,19
5,0,41,4;18,17,22,21,20,15,10,5,0,1,2,3;16,11,12;4,9,14,19,24,23;6,7,8,13
6,0,42,5;34,35,29,23,17,16,10,9,8,7,13;31,32,33,27;28,22,21,15,14;11,5,4,3,2,1,0,6,12,18,19,20;30,24,25,26
7,0,43,6;10,9,8,7,0;37,44,45,46,47,48,41,34,27,20,13,6,5,4,11,18;1,2,3;30,31,38,39,40,33,26,19,12;35,28,21,14,15,16,17;32,25,24,23,22,29,36,43,42
8,0,44,6;61,62,63,55,47,39,31,23,15,7,6,5,13,21,29,28,27,26;14,22,30,38,46,54,53,52,60,59,58,57,56,48;18,19,20,12,4;33,25,17,9,10,11,3;45,44,43,51,50,49;2,1,0,8,16,24,32,40,41,42,34,35,36,37
9,0,45,7;51,50,49,48,47,46,45,36,27,18,9,0,1,2,3,4,5,6,7,8,17,26;71,70,69,60,59,58,57,56,55,54,63,72,73,74,75,76;64,65,66,67,68,77,78,79,80;10,11,12,13;52,43,42,41,40,39;38,37,28,19,20,21,22,23,14,15,16,25,34,35,44,53,62,61;29,30,31,32,33,24
8,0,46,8;33,34,26,27,28;12,4,5,6,7,15,23,31,39,47,55,63,62,61,60,59,58,57,56;36,35,43,42,41;38,46,54,53,52,51,50,49;48,40,32,24,16,8,0,1,2,3,11;21,20,19,18,10;13,14,22,30,29,37,45,44;25,17,9
7,0,47,6;30,23,16,15,14,21,28,35,42,43,44,45,46,47,48,41,34,27;8,9,10,17,24;13,20,19,26,33,40,39;36,29,22;6,5,4,3,2,1,0,7;12,11,18,25,32,31,38,37
6,0,48,5;15,21,20;30,31,25,19,13,7;32,33,34,35,29,23,17,11,5,4,3;2,1,0,6,12,18,24;26,27,28,22,16,10,9,8,14
5,0,49,4;4,3,2,1;13,18,17,16;12,11,10,15,20,21,22,23,24,19,14;0,5,6,7,8,9
6,0,50,3;6,7,8,9,10,16,22,28,27,26,20,19,18,24,30;25,31,32,33,34,35,29,23,17,11,5,4,3,2,1,0;12,13,14,15,21
7,0,51,7;24,25,32,39,46,45,44,43,42,35,28,29,22,15,8,1,2;5,12,19,26,33,40;30,23,16,9,10,3,4;36,37,38,31;6,13,20,27,34,41,48,47;21,14,7,0;17,18,11
8,0,52,7;46,45,44,43,35;49,41,33;54,53,52,51,50,42,34;13,12,11,10,9,17,25,26,27;18,19,20,21,22,14;28,29,30,31,23,15;7,6,5,4,3,2,1,0,8,16,24,32,40,48,56,57,58,59,60,61,62,63,55,47,39,38,37,36
9,0,53,7;54,55,56,57,48,49,40;29,20,21,22,23,14,15,16,25,34,43,52,61,62;58,59,50,41,32,31,30,39,38,47,46,45,36,27,18,9,0,1,2,3,4,5,6,7,8,17,26,35,44,53;63,72,73,74,75,76,77,78,79,80;64,65,66,67,68,69,70,71;13,12,11,10,19,28,37;24,33,42,51,60
8,0,54,7;46,54,53,52,51,50,49,48,40,32,24;20,21,22;9,10,18,26;34,35,36;28,29,30,31,23,15,7,6,5,4,3,2,1,0,8,16,17,25,33,41,42;27,19,11,12,13,14;56,57,58,59,60,61,62,63,55,47,39,38,37,45,44,43
7,0,55,7;4,5,6,13;11,18,25,26,27,34;33,32,31,24,17,10,3;47,46,45,44,43,42,35,28,21,14,7,0,1,2;12,19,20;48,41,40,39,38,37,36,29,22,15,8;30,23,16,9
6,0,56,5;33,34,35,29;27,26,20,14,8,9;32,31,30,24,18,12,6,0,1,2,3,4,5,11,17,23,22,28;10,16,15,21;25,19,13,7
5,0,57,3;1,2,3,4,9,14,13,12,11,10,15,20,21,22,23;8,7,6,5,0;24,19,18,17,16
6,0,58,5;35,29,23;22,16,17,11,5,4,3,2,1,0,6,12,18,24,30;34,33,32,26,20;10,9,8,7,13,19,25,31;28,27,21,15,14
7,0,59,7;47,48,41,34,27,20;30,31,32,33,26,19;44,43,42,35,28,21,14,7,0,1;2,9,8,15,22,29,36,37,38,45;13,6,5,4,3,10,17,16;12,11,18,25,24,23;40,39,46
8,0,60,5;17,18,10,11,12,13,14,22,30,38,46,54,53,52,51,50;0,8,16,24,25,26,27,19,20,21;9,1,2,3;4,5,6,7,15,23,31,39,47,55,63,62,61,60,59,58,57,56,48,40,32,33,34,35,36,28,29;49,41,42,43,44,45,37
9,0,61,9;70,61,60,51,50,41,32,23,14,5,4,3,2;80,71,62,53,52,43,34;48,49,40;19,18,9;0,1,10,11,12,13,22,31,30,39,38,47,56,57,58,59,68,69,78,79;44,35,26,17,8,7,6,15;77,76,67,66,65,64,55,46,37,28,29,20,21;27,36,45,54,63,72,73,74,75;16,25,24,33,42
8,0,62,7;59,51,50,42;21,29,37,45,44,43,35;2,1,0,8,16,24,32,33,41,49;53,54,46,38,30,22,14,13,12,20,28,36;40,48,56,57,58;34,26,25,17,9,10,11,3,4,5,6,7,15,23,31,39,47,55,63,62,61,60,52;27,19,18
7,0,63,6;32,33,26,19;24,25,18,11,12,13,20,27,34,41,40,39;6,5,4,3,10,17,16,23,30,31;9,8,15,22,29,36,37;48,47,46;38,45,44,43,42,35,28,21,14,7,0,1,2
6,0,64,6;35,34,33,32;28,29,23,17,11,10,9,8,2,1,0,6,12,18,24,30,31;5,4,3;27,21,20,14,13,7;26,25,19;15,16,22
5,0,65,4;20,15,16,17,18;5,10,11,12,13;4,3,2;21,22,23,24,19,14,9,8,7,6,1,0
6,0,66,5;28,27,26,20,19,13,7;34,33,32,31,25;8,14,15,21,22;11,5,4,3,2,1,0,6,12,18,24,30;9,10,16,17,23,29,35
7,0,67,6;45,46,47,48,41,34,27,20,13,6,5,4,3,2,1;0,7,8,9,10,11,12,19,26;40,39,38,31;16,17,18;36,29,22;33,32,25,24,23,30,37,44,43,42,35,28,21,14,15
8,0,68,7;56,48,40,32,24;63,62,61,60,59,58,57,49;55,54,53,52,51,50,42,41,33,25,17,16,8,0,1,2,3,11,19,27,28,36,37,38,39,31;23,22,14,13,5;15,7,6;47,46,45,44,43,35,34,26,18,10,9;4,12,20,21,29,30
9,0,69,9;75,76,77,68,69,70;48,49,40,31,22,13,12,11,10;15,14,23,32,41;50,51,42,33,24,25,16;29,28,37,46,55,64;66,67,58,59,60,61,52,43,34;27,36,45,54,63,72,73,74,65,56,57;20,19,18,9,0,1,2,3,4,5,6,7,8,17,26,35,44,53,62,71,80,79,78;21,30,39,38,47
8,0,70,8;63,55,54;52,44,43,42,34,26,18,10,9,8,16,24,32,40,48,56,57,58;14,22,30,38;27,19,11,3,2,1,0;45,37,29,21,13;62,61,53;35,36,28,20,12,4,5,6,7,15,23,31,39,47,46;17,25,33,41,49,50,51,59,60
7,0,71,6;24,23,16;34,41,48,47,46,45;31,30,37,44,43,42,35,28,21,14,7,0,1,2,3,4,5,6,13,20;17,18,25,32;27,26,33,40,39,38;36,29,22,15,8,9,10,11,12,19
6,0,72,4;20,14,15,16,22,28,34,33;35,29,23,17,11,5,4,3,2,1,0,6,12,18;24,30,31,32,26,27,21;10,9,8,7,13,19,25
5,0,73,4;2,3,8,13,12,11;1,6,7;4,9,14,19,18,17,16;0,5,10,15,20,21,22,23,24
6,0,74,5;30,24,18,12,6,0,1,2,8,9,10;35,29,28,27,26;3,4,5,11,17,23;16,15,14,13,7;22,21,20,19,25,31,32,33,34
7,0,75,6;6,13,20,27,34;9,16,23,30;8,15,22,29,36,37,38,31,24,17,10;2,1,0,7,14,21,28,35,42,43,44,45;48,47,46,39,32,25,18,11;41,40,33,26,19,12,5,4,3
8,0,76,7;47,39,38,30,22,14,13,12,11,10,9;49,50,51,52,53;62,61,60,59,58,57;41,42,43,44,36,28,20,21;29,37,45,46,54,55,63;56,48,40,32,33,34,35,27,19,18,17,16,8,0,1,2,3,4,5,6,7,15,23,31;24,25,26
9,0,77,9;15,14,13,12,11,10,19,28,37,46,55,64;53,62,71,80,79,78,77,68,67,66;32,23,24;33,34,25,16;30,39,48,57;49,50,51,52,61;70,69,60,59,58;43,42,41,40,31,22,21,20,29,38,47,56,65;44,35,26,17,8,7,6,5,4,3,2,1,0,9,18,27,36,45,54,63,72,73,74,75,76
8,0,78,7;9,10,11,12;49,41,33,34,26,27;57,58,59,60,61,62,63,55,47,39,31,23,15;7,6,5,13,21,29,37,45,44,52,51;25,17,18,19,20,28,36,35,43,42,50;14,22,30,38,46,54,53;56,48,40,32,24,16,8,0,1,2,3,4
7,0,79,6;6,5,4,3,2,1,0,7;8,9,10,11,12;13,20,27,34,41,48,47,46,45,44,43,42,35,28,21,14;15,16,17,24;18,25,32,31,30,23;19,26,33,40,39,38,37,36,29,22
6,0,80,5;16,10,9,8,7,13,19;18,12,6,0,1,2,3,4,5,11,17,23,22,21,15;29,28,27;24,30,31,32,33,34,35;14,20,26,25
5,0,81,5;8,13,12,17,16,15,20;7,6,11,10;24,19,14,9;4,3,2,1,0,5;21,22,23,18
6,0,82,5;31,30,24,18,12,6,0,1,2;7,8,9,3,4,5,11,17,23,29,35;34,28,27;33,32,26,20,21,22;25,19,13,14,15,16,10
7,0,83,5;29,22,15,14;40,39,38;12,19,26,33,32,31,30,37,36,35,28,21;7,8,9,16,23,24,25,18,11,4,5,6,13,20,27,34,41,48,47,46,45,44,43,42;0,1,2,3,10,17
8,0,84,6;41,40,32,24,16,8,9,10,11,12,13,14;51,52,53,45,37,29,21,20,19,18,17,25,33;31,39,47,55,63;44,36,28,27,26,34;0,1,2,3,4,5,6,7,15,23,22,30,38,46,54,62,61,60,59,58,57,56,48;35,43,42,50,49
9,0,85,7;46,45,36,27,18,9,0,1;20,29,30,39,48,57,66,65,64,55,54;61,52,43,34,25,16,15,14,23,32,41,50,59,68,77,78,79;80,71,70,69,60,51,42,33,24;63,72,73,74,75,76,67,58,49,40,31,22,21,12;56,47,38,37,28,19,10,11,2,3,4,13;62,53,44,35,26,17,8,7,6,5
8,0,86,7;51,52,53,54,46,38,30,22,14,13,12,11,10,2,1;16,24,32,33,41,49,50;43,44,45;40,48,56,57,58,59,60,61,62,63,55,47,39,31,23,15,7,6,5,4,3;20,19,18,17,9,8,0;42,34,35,36,37,29,21;25,26,27,28
7,0,87,6;8,9,16,23,30,31,32,33;10,17,18;15,14,21,28,35,42,43,44,45,46,47,48,41;24,25,26,19,12,11;34,27,20,13,6,5,4,3,2,1,0,7;22,29,36,37,38,39,40
6,0,88,5;13,14,15,21;4,10,9,8,7;23,29,35,34,33,32,31,30;3,2,1,0,6,12,18,19,20;24,25,26,27,28,22,16,17,11,5
5,0,89,4;6,11,16,21;4,3,2,1,0,5,10,15,20;9,8,7,12,17,22,23,24,19;18,13,14
6,0,90,5;0,6,7,8,9,10,16,17;19,25,31,32,33;35,34,28,27,26,20;1,2,3,4,5,11;29,23,22,21,15,14,13,12,18,24,30
7,0,91,6;19,26,25,32,31,30;37,36,29,28,21,14,7,0,1,2,9,16,23;10,3,4,5,6;22,15,8;41,48,47,46,45,44,43,42,35;24,17,18,11,12,13,20,27,34,33,40,39,38
8,0,92,6;9,10,11,12,4,5,6,7,15,23,31,39,47;26,27,28,29,21,13;62,61,53;42,34,35,36,37,38,30,22,14;52,60,59,58,57,56,48,40,32,24,16,8,0,1,2,3;63,55,54,46,45,44,43,51,50,49,41,33,25,17,18,19,20
9,0,93,9;32,41,40,39,38,37,28,19,20,21,12,13;74,73,72,63,54,55;0,1,2,3,4,5,6,7,8,17,26,35,44,53,62,71,80,79,78,77,76,75;66,67,58,59,60;22,31,30,29;57,56,65,64;47,48,49,50,51,42,33,24;68,69,70,61,52,43,34,25,16,15,14,23;11,10,9,18,27,36,45,46
8,0,94,7;23,15,7,6,5,4,3,11,10,9;56,57,49;42,43,44,45;41,33,34,35,36,37,38,46,54,53,52,51,50;2,1,0,8,16,17,18,19,20,21,29,30,31,39,47,55,63,62,61,60,59,58;22,14,13,12;48,40,32,24,25,26,27,28
7,0,95,6;48,41,40,39,38;18,25,32,33,34,27,20,13,6,5,4,3,2,1,0,7;14,21,28,35,36,37,30,31,24;26,19,12,11,10,9,8,15;42,43,44,45,46,47;29,22,23,16,17
6,0,96,6;31,32,33,34,35,29,23,17,11,5,4,3,2,1,0;26,20,19,18,12;25,24,30;6,7,8,9;27,21,15,14,13;28,22,16,10
5,0,97,5;16,11,6,1,2,3,8;24,19,18;21,20,15,10,5,0;4,9,14,13;23,22,17,12,7
6,0,98,6;20,14,8;30,31,32,33,34,35,29,23,17,11,5;4,10,16,22,28;2,3,9,15,21,27,26,25,24,18;0,1,7;19,13,12,6
7,0,99,6;39,38,37,30;31,24,23;8,9,16,17,18,25,32;7,14,15,22,29,36;0,1,2,3,4,5,6,13,20,27,34,41,48,47,46,45,44,43,42,35,28,21;40,33,26,19,12,11,10
8,0,100,8;54,46,38,30,22,23;18,26,25,33,32,40,48,56,57,58,59,60,52;9,17,16,24;8,0,1,2,10;31,39,47,55,63,62,61;50,51,43,44,36,28,20,12,13,14,15,7;6,5,4,3,11,19,27,35,34,42,41,49;53,45,37,29,21
9,0,101,9;29,20,11,10;73,74,75,76,77,78,79,80,71,62,61,52,51,42,33,24,23,22,21;12,13,14,15,16,25,34,43;38,47,46,45,36,27,18,9,0,1,2,3,4,5,6,7,8,17,26,35,44,53;50,59,60,69,70;48,39,30,31,32,41;40,49,58,57,56,55,54;19,28,37;72,63,64,65,66,67,68
8,0,102,5;28,27,35,34,33;8,0,1,2,3,4,5,6,7,15,23,31,39,47,55,63;48,49,50,51,52,53,45,37,29,21,20,19,18,26,25;56,57,58,59,60,61,62,54,46,38,30,22,14,13,12,11,10,9,17,16;24,32,40,41,42,43,44,36
7,0,103,6;3,4,5,6,13,20,27,34,41,48,47,46,39,32,25,18,17;29,30,23,16;1,2,9,10,11,12,19,26,33,40;0,7,8,15,22;45,44,43,42,35,28,21,14;24,31,38,37,36
6,0,104,6;6,7,8;21,15,16;14,20,19,25,31,32,33,34,35,29,23,17,11,5,4;13,12,18,24,30;0,1,2,3,9,10;26,27,28,22
5,0,105,4;19,14,9,8,7,12;4,3,2,1,6,11,16;13,18,23,24;17,22,21,20,15,10,5,0
6,0,106,5;34,33,32,31,30,24,18,12,6,0,1;5,11,17,23,29,35;2,3,4,10,16,22,28;9,15,21,27,26,25,19,13,7;20,14,8
7,0,107,7;28,29,36,37,38,39;6,5,12,11,10,9,8,7;35,42,43,44,45,46,47,40,33,32,31,30,23,22;48,41,34,27,26,25,24;4,3,2,1,0;19,20,13;18,17,16,15,14,21
8,0,108,7;8,0,1,2,3,4,5,6,14;34,42,43,44,45,37;29,28,20,19,18,26,25,33,41,49,50,51,52,53,54,46,38;47,55,63,62,61,60,59,58,57,56,48,40,32,24,16,17,9,10,11;36,35,27;39,31,30,22,21,13,12;23,15,7
9,0,109,8;37,46,47,56,57,58,59,60,51,42,33,24,23,22,13,12;16,25,34,43,52,61,70,69,68,67,66,65,64,55;21,30,31,40;6,7,8,17,26,35,44,53,62,71,80,79,78,77,76,75,74,73,72,63,54,45;48,39,38,29,20,11;32,41,50,49;15,14,5,4,3,2,1,0,9,18,27,36;28,19,10
8,0,110,8;27,26,34,33,32,40,48,56;3,4,5,6,7,15,23,31,39,47,55,63,62,61,60,59,58,50;9,17,18,19;42,41,49,57;21,29,37,45,44;28,36,35,43,51,52,53,54,46,38,30,22;20,12,13,14;25,24,16,8,0,1,2,10,11
7,0,111,5;7,14,21,28,35,42,43,44,45,46,47,48,41,34,27,20,13,12;6,5,4,11;24,25,32;0,1,8,9,16,23,30,31;2,3,10,17,18,19,26,33,40,39,38,37,36,29,22,15
6,0,112,6;13,7,8;35,34,33,32,31,30,24,18,12,6,0,1,2,3,4,5,11;19,20,14;25,26,27,28,29;9,15,21,22,23;10,16,17
5,0,113,5;6,5,10,15,20,21;4,3,2,1,0;11,16,17,22;23,18,13,12,7;24,19,14,9,8
6,0,114,5;15,14,13;2,1,0,6,12;21,20,19,18,24,30,31,32,33,34,35,29,23;25,26,27,28,22,16,10;17,11,5,4,3,9,8,7
7,0,115,6;40,33,26,19,12,5;29,22,15,8,9,10;47,48,41,34,27,20,13,6;24,25,32,39,46,45,44,43,42;18,17,16,23,30,31,38;37,36,35,28,21,14,7,0,1,2,3,4,11
8,0,116,8;7,6,14,22,30,29;24,16,8,0,1,2,3,4,5,13,21;36,35,27,19,18,17;38,37,45,44,52,51,50,49,41,33,25;15,23,31,39,47,55,63,62;46,54,53,61,60,59,58,57,56,48,40,32;9,10,11,12,20,28;43,42,34,26
9,0,117,7;8,17,26,35,34,33,32,31,40;55,46,37,28,19,10,9;11,20,29,38,47,56,57,58,59,60,51,52;12,13,14,15,6;71,80,79,78,77,76,75,74,73,72,63,54,45,36,27,18;7,16,25,24,23,22,21,30,39,48,49,50,41,42,43,44,53,62,61,70,69,68,67,66,65,64;0,1,2,3,4,5
8,0,118,6;15,23,31,39,47,55,63,62;12,11,10,9,17;1,0,8,16,24,32,40,48,56,57,58,59,60,52;2,3,4,5,13,21,20,19,18,26,25,33,41,49,50,51,43,44,36,37,38,46,54;7,6,14,22,30,29,28,27,35,34,42;61,53,45
7,0,119,7;34,41,48,47;17,24,31,32;16,23,30;5,6,13,20,19;27,26,25,18;38,37,36,29,22,15,8,9,10,11,12;33,40,39,46,45,44,43,42,35,28,21,14,7,0,1,2,3,4
6,0,120,5;15,14,20;1,7,8;9,10,16,22,21;2,3,4,5,11,17,23,29,28,27,26,25,19,13;0,6,12,18,24,30,31,32,33,34,35
