5,0,1,5,12,0:4:20:24;2,7,12,17;1,6,5;3,8,9;10,11,12,13,14;15,16,21,22,23,18,19
5,0,2,4,6;21,20,15,10;12,13,18;0,5,6,7,8,9,14,19,24,23,22,17,16;11,6,1,2,3,4
5,0,3,3,8;2,1,6,11,16,17,18;0,5,10,15,20,21,22,23,24,19,14,13,8,3;12,7,8,9,4
5,0,4,5,11;15,20,21,22;4,3,2,1,0,5,10,11,12,13;17,18,23;9,8,7,6,11,16;24,19,14
5,0,5,4,6;10,15,20,21;1,6,11,12,13,18;8,7,6,5,0;16,17,22,23,24,19,14,9,4,3,2
5,0,6,4,7;20,15,10,5,0,1,2,7,12,17,22;21,16,11,6,7,8;19,14,9,4,3;13,18,23,24
5,0,7,5,16;20,21,16,11,12,13,8,3,2,1,0;7,6,5;22,23,24;14,9,4;10,15,16,17,18,19
5,0,8,3,17;19,14,13;4,9,8,7,6,11,16,17,18,23,24;3,2,1,0,5,10,15,20,21,22,17,12
5,0,9,4,8;13,8,3,4;14,19,18,17,12;24,23,22,21,20,15,10,5,0,1,2;9,8,7,6,11,16
5,0,10,3,11;4,3,8,13,18,17,16,11,6;5,0,1,2,7;9,14,19,24,23,22,21,20,15,10,11,12
5,0,11,4,16;0,1,2,7;10,5,6;9,14,19,24,23,22,21,16,11,12;4,3,8,13,18,17,16,15,20
5,0,12,5,18;23,18,13,8;12,7,6;15,20,21,22,17,18,19,24;2,1,0,5,10,11,16;14,9,4,3
5,0,13,4,11;23,18,17;24,19,14,13,12,11,10,5,0,1,2,3;16,11,6,7,8,9,4;15,20,21,22
5,0,14,5,8;20,15,10;5,6,7,8,9,4;12,17,18,23;11,16,21,22;24,19,14,13,8,3,2,1,0
5,0,15,3,13;19,24,23,22,21,20;11,6,7,8,13,18,17;16,15,10,5,0,1,2,3,4,9,14,13,12
5,0,16,4,13;8,13,18,19,24;1,0,5,10,15,20,21;16,11,6,7,2,3,4;23,22,17,12,13,14,9
5,0,17,3,17;8,7,6,11,16,17,18,19;24,23,22,17,12,13,14,9;21,20,15,10,5,0,1,2,3,4
5,0,18,3,13;15,10,5,0,1,2,3,4,9,14,13,12,17;16,11,6,7,8,13,18;19,24,23,22,21,20
5,0,19,5,6;16,17,12,7,6,5;0,1,6,11,10,15;4,3,2;20,21,22,23,24,19,14;18,13,8,9
5,0,20,4,6;24,19,14;17,16,15,10;20,21,22,23,18,13,12,11,6,1,2,3;0,5,6,7,8,9,4
5,0,21,5,12;10,5,0;24,23,22,21,20;7,12,17,18,19,14;6,1,2,3;4,9,8,13,12,11,16,15
5,0,22,4,12;2,3,4,9,14,19,24,23,22,21,16;7,12,17,18;20,15,10,5;0,1,6,11,12,13,8
5,0,23,4,17;2,1,0,5,10,15,20,21;13,14,9;24,23,22,17,12;19,18,17,16,11,6,7,8,3,4
5,0,24,4,12;4,9,14,19,18;24,23,22,21,20,15,10;5,6,7,12,17,16;0,1,2,3,8,13,12,11
5,0,25,5,16;6,11,16,21,20;9,4,3,2,1,0,5,10;15,16,17,18,13;22,23,24,19,14;8,7,12
5,0,26,5,8;12,17,18,23;24,19,14,13,8,3,4;6,11,16,21,22;9,8,7,2,1,0,5;10,15,20
5,0,27,5,6;20,15,10;21,16,17;8,7,6,5,0;4,3,2,1,6,11,12,13,18;22,23,24,19,14,9
5,0,28,4,6;20,15,10,5,6,7,8;19,24,23,22,17,12;0,1,6,11,16,21;2,3,4,9,14,13,18
5,0,29,5,18;4,3,2,1,6,11,16,15,20;7,8,9,14;24,19,18,17,22,21;12,13,18,23;10,5,0
5,0,30,4,12;8,13,12,11,6,1,0;5,10,15,20,21,22,23,18;16,17,12,7;2,3,4,9,14,19,24
6,0,1,5,28;5,4,10,16,22,28,34,35;13,12,6,0,1,2,3,9,15,21,20,26,25;7,8,14;11,17,23,29,28,27,33,32,31,30;24,18,19
6,0,2,5,16:13;34,33,32,26,20,14,13,12,6,0,1,2,3;10,16,22,23,29,35;28,27,21,15,16,17,11,5,4;30,24,18;31,25,19,13,7,8,9
6,0,3,4,20;31,25,19,20,21,22,16,17,11,5,4,3,2,1,0,6;23,29,28,27;10,9,15,14,20,26,32,33,34,35;8,7,13,12,18,24,30
6,0,4,6,27;13,7,8,9,10,11,5;17,23,22,28,27,26,32,31;12,6,0,1,2,3,4;21,27,33,34,35,29;16,15,14,20,19,18;25,24,30
6,0,5,7,28;35,34,28,22;14,13,19,25;33,32,26,20,21,15;27,28,29,23;11,5,4,3,2;17,16,10,9,8,7,1;0,6,12,18,24,30,31
6,0,6,5,16:7;11,5,4,3,2,1,7,13,14;24,25,26,20,21;27,28,22,16,10;30,31,32,33,34,35,29,23,17,16,15,9,8,7,6,0;12,18,19
6,0,7,5,16;34,35,29,23;12,6,0,1,2,3,4,5,11,17,16,15,14,20;28,27,33,32;26,25,19,13,7,8,9,10,16,22,21;31,30,24,18
6,0,8,4,26;19,13,7,8,9,10,16,22,28,29;33,34,35;23,17,11,5,4,3,2,1,0,6,12,18,24,30,31,32,26,20,14,15;25,26,27,21
6,0,9,6,25;27,28,29;35,34,33,32;30,31,25,19,13;16,10,4;7,8,14,20,26,25,24;5,11,17,23,22,21,15,9,3,2,1,0,6,12,18
6,0,10,5,8;2,8,14,20,21;6,12,18,24,30,31;32,33,34,35,29,23,17,11,5,4,3;15,9,8,7,1,0;13,19,25,26,27,28,22,16,10
6,0,11,4,28;35,29,28,27,26,25,24,30;18,12,6,0,1,2,3,4,5,11,17,23;14,15,16;31,32,33,34,28,22,21,20,19,13,7,8,9,10
6,0,12,6,16;31,30,24,18,12,6,0,1;9,10,16,22,28;35,34,33,32,26,25,19,13;27,21,20;2,3,4,5,11;29,23,17,16,15,14,8,7
6,0,13,5,15;35,34,28,27,26,25;6,12,18,24,30,31,32,33;16,15,14,8,2,3,4,5;29,23,22;0,1,7,13,19,20,21,15,9,10,11,17
6,0,14,5,15;22,28,27;17,23,29,35,34,33;26,20,14,15,16,10,11;21,15,9,8,7,13,19,25;32,31,30,24,18,12,6,0,1,2,3,4,5
6,0,15,5,27;9,10,16,22,28,27,26,25;0,6,7,8;1,2,3,4,5,11,17,23,29,35,34;31,32,33,27,21,20,19;30,24,18,12,13,14,15
6,0,16,5,20;33,34,35,29,23,17,11,5,4,3,2,1,0,6,12;9,8,7,13;18,24,30;32,31,25,19,20,21,22;28,27,26,20,14,15,16,10
6,0,17,4,21;11,5,4,3,2,1,0,6,12,18,24,30,31;32,26,25,19,13,7,8,9,10,16,17;28,27,21,15;14,20,21,22,23,29,35,34,33
6,0,18,5,20;3,9,15,21,20,19,13;12,6,0,1,2;30,24,18;5,11,17,23,29,35,34,33,32,31,25;4,10,16,22,28,27,26,20,14,8,7
6,0,19,4,27;23,17,11,5,4,3,2,1,0,6,12,18,24,30,31,32;29,35,34,33,27,21,22,16,10,9,8,7,13;15,14,20,19;25,26,27,28
6,0,20,4,15;29,35,34,33,32,31,30,24,18,12,6,0,1,2,3,4,5,11;10,16,15,14,13,19,25;7,8,9,15,21,22,23,17;20,26,27,28
6,0,21,5,14;22,28,34,35;33,32,31,30,24,18,12,6,0;19,25,26,27;29,23,17,11,5,4,3,2,1,7,13,14,15,21;16,10,9,8,14,20
6,0,22,6,27;23,29,35,34,33,27,21;8,9,10;3,4,5,11,17;25,19,20,14,15,16;6,0,1,2;22,28,27,26,32,31,30,24,18,12,13,7
6,0,23,5,16:7;34,35,29,23,22,16,10,9;0,1,7,13,14,20,21,27,28;24,30,31,32,33;8,7,6,12,18,19,25,26;15,16,17,11,5,4,3,2
6,0,24,5,21;31,30,24,18;13,14,15,21,27;19,25,26,32,33,34,35,29,23,17,16,10,9,8,7;28,22,21,20;11,5,4,3,2,1,0,6,12
6,0,25,5,7;35,34,33,32,31,30,24,18,12,6,7,8,2,3;0,1,7,13,19;21,22,16,10,4;5,11,17,23,29,28,27,26,25;9,15,14,20
6,0,26,6,13:10;34,33,27;18,24,30;28,22,16,10,4,5;15,14,13,12,6,0,1,2,3;32,26,20,21;31,25,19,13,7,8,9,10,11,17,23,29,35
6,0,27,5,20;25,26,20,14,15,16,22,23,29;19,20,21,27,28,34,35;17,11,5,4,3,2,1,0,6,12,18,24,30;13,7,8,9,10;33,32,31
6,0,28,5,20;22,16,10,9,8,7;18,24,30,31,32,33,27,28;14,20,26,25;34,35,29,23,17,11,5,4,3,2,1,0,6,12,13;19,20,21,15
6,0,29,6,27;8,7,13;14,20,19,25;10,16,22,28,27,26;4,5,11,17,23,29,35,34,33,27,21,15;2,3,9;32,31,30,24,18,12,6,0,1
6,0,30,4,25;1,2,3,4,10,16,15,14,13,12,18,24,25,26,27,28,29,35;0,6,7,8,9;34,33,32;5,11,17,23,22,21,20,19,25,31,30
7,0,1,7,29;0,1,2,3,10,17;44,37,36,29,22,21,14,7,8,9;43,42,35,28,29,30;18,11,4,5,6,13,20,27,34,33;41,40,39,32;15,16,23,24,25,26,19,12;31,38,45,46,47,48
7,0,2,5,10;36,29,30,31,32,33,26;27,20,13,6,5,4,11,10,9,8,15,22;24,25,18,19,12;37,38,39,40;34,41,48,47,46,45,44,43,42,35,28,21,14,7,0,1,2,3,10,17,16,23
7,0,3,5,22;2,3,4,5,6,13,20,27,34,41,48,47,46,45,44,37,36,29,22,15,14,7,0;43,42,35,28,21,22,23;16,17,24;30,31,32,25,18,11,10,9,8,1;38,39,40,33,26,19,12
7,0,4,7,25;5,6,13,20,27,34,41;46,47,48;4,3,2,1,0,7,14,21,28,35,42;8,9,10,11,12,19;30,23,24,25,26,33,40,39,38,45,44;29,22,15,16,17,18,25,32,31;37,36,43
7,0,5,5,30;19,12,11,10,9,8,15,22,23,30,37,36,43;26,33,40;16,17,18,25,32,39,38;24,31,30,29;42,35,28,21,14,7,0,1,2,3,4,5,6,13,20,27,34,41,48,47,46,45,44
7,0,6,5,31;6,5,4,3,2,1,0,7,14,21,28,35,42,43;45,38,31,24,25,26,33,40;17,18,19,20,27,34,41,48,47;46,39,32,31,30,23,16,9,10,11,12,13;44,37,36,29,22,15,8
7,0,7,6,10;26,19,18,17,10,3,2,1;42,43,44,45,46,47,48,41,34,33,32,25,24,23,16,15,14,7,0;12,11,10,9,8;21,28,35,36,37,38,39,40;31,30,29,22;27,20,13,6,5,4
7,0,8,6,16;7,0,1,2,3,10,11,12,13,20,27,34;41,48,47,46,45,44,43,42,35,28,21,14;8,9,16,23,24,25,18;19,26,33,40,39,38,37,36;17,16,15,22,29,30,31,32;4,5,6
7,0,9,6,19:36;13,12,19,26,33;16,9,2,1,0,7,14,21,28,29,36,43,42;20,19,18,11,4,5,6;27,34,41,48,47,46,45,44,37,36,35;3,10,17,24,25,32,39,40;8,15,22,23,30,31,38
7,0,10,6,16:33;43,44,45,46,47,48,41,34,33,32;20,19,12,11,10,17,16,15,22;23,16,9,8;42,35,36,37,30,31,24,25,18;13,6,5,4,3,2,1,0,7,14,21,28,29;38,39,40,33,26,27
7,0,11,6,24;46,47,48;44,45,38,39,32,33,26,19,18;6,5,4,3,2,1,0,7,14,15,16,17,24,31,30,37;43,42,35,28,21;25,24,23,22,29,36;40,41,34,27,20,13,12,11,10,9,8
7,0,12,5,38;32,33,40;16,17,24,25,26,27,34,41,48,47;6,5,4,3,2,1,0,7,14,21,28,35,42,43,44,45,38,31,30,23;46,39,38,37,36,29,22,15,8,9,10,11,12,13;20,19,18
7,0,13,6,15;37,44,43,42,35,28,21;1,0,7,14,15,16,17,10,11,12,5;32,25,24,23,22,15,8,9,2,3,4;33,40,39,38,31,30,29,36;6,13,20;18,19,26,27,34,41,48,47,46,45
7,0,14,6,11:8;26,25,32,39,38,37,36,29,22,23,16,17;30,31,24;9,8,7,0;19,12,11,10,3;18,11,4,5,6,13,20,27,34,41,48;2,1,8,15,14,21,28,35,42,43,44,45,46,47,40,33
7,0,15,6,12;8,9,16,23,24,31,32,33;41,48,47,46,45,44,43,36;42,35,28,21,14,7,0,1,2,3,4,11,12,13,6;5,12,19,20,27,34;10,17,18,25,26;40,39,38,37,30,29,22,15
7,0,16,7,24;40,39,38,37;17,24,31,32,33,26,19,12,5,4,3,2,1,8;6,13,20,27,34,41,48,47,46,45,44;14,7,0;36,43,42;21,22,15,16,9;10,11,18,25,24,23,30,29,28,35
7,0,17,6,12:30;36,37,30,23,24,25,32;6,13,12,11,18,17,16,15,22,29,30,31;21,28,35,42,43,44,45,38,39,40,33,26,27,20;46,47,48,41,34;10,9,8;19,12,5,4,3,2,1,0,7,14
7,0,18,6,10;45,46,39,40;20,13,6,5,4,3,10,17,16,15;33,32,31,30;8,7,14,21,28,35,42,43,44;18,25,24,23,22,29,36,37,38;0,1,2,9,10,11,12,19,26,27,34,41,48,47
7,0,19,4,29;35,42,43,44,45,46,39,32,25,18;17,24,31,38,37,36,29,22,15,8,9,2,3,4,5,6,13,20,27,34,41,48;1,0,7,14,21,28,29,30,23,16;47,40,33,26,19,12,11,10
7,0,20,6,18;6,5,4,3,2,1,0;14,21,28,35,36,37,38,39,40,41,34,27;20,13,12,11,18,25,24,23;16,15,22,29,30,31,32,33,26;42,43,44,45,46,47,48;19,18,17,10,9,8,7
7,0,21,5,39;48,47,40,39,38,37;35,42,43,44,45,46,39,32,33,26,19,12,11,10,17,16,23,22,21,14,7,0,1;18,25,24,31,30;36,29,28;15,8,9,2,3,4,5,6,13,20,27,34,41
7,0,22,6,31;33,40,47,46,45,44,43,42,35,28,21,14,7,0,1,2,3,4;5,6,13,20,27;18,25,26;24,31,38,37,36,29,22,15,8,9,10,11,12,19;34,41,48;17,16,23,30,31,32,39
7,0,23,7,12;22,23,24,31,32,39,46,47,48,41,34,27,20,19,12,5;45,44,43;6,13,12,11;10,9,8;42,35,36,37,38;40,33,26,25,18,17,16,15,14,7,0,1,2,3,4;30,29,28,21
7,0,24,5,15;47,48,41,34,27,20,13,6,5,4,11,10,17,24,23,30,29;18,25,32,31,38,37,36;21,28,35,42,43,44,45,46,39,40,33,26,19,12;0,1,8,15,22;7,14,15,16,9,2,3
7,0,25,7,36;12,5,6;13,20,19;27,26,25,24,17,16,15,14,7,0,1,2,3,4;23,22,21,28;8,9,10,11,18;33,40,39,38,37,36,35,42;34,41,48,47,46,45,44,43,36,29,30,31,32
7,0,26,7,25:29;36,29,22,23,16,17,18,25,32,33,40;27,34,41,48,47,46;20,13,6,5,4,3,2,1,0,7;42,35,28,29,30,37,38,39;45,44,43;21,14,15,8,9,10,11,12,19;31,24,25,26
7,0,27,7,15:40;32,31,38,37,36,29,22,15,8,9;48,47,40,33,34,27,20,19,18;10,3,4,5;2,1,0,7;11,12,13,6;26,25,24,23,30;41,40,39,46,45,44,43,42,35,28,21,14,15,16,17
7,0,28,6,29;28,29,30,23,16,15;6,13,20,19,18,17,24,31,38,37,44,43;8,9,10,11;42,35,36,29,22,21,14,7,0,1,2,3,4,5,12;47,40,33;48,41,34,27,26,25,32,39,46,45
7,0,29,6,22;9,10,11,12,13,20,27,26,33,40;0,7,14;16,17,18,19;34,41,48,47,46,45,44,43,42,35,28,21,22,23,30,31;39,38,37,36,29,22,15,8,1,2,3,4,5,6;24,25,32
7,0,30,6,9:26;30,23,16,9,2,1,0,7;48,41,40,39,32,25,26,27,20,13,6,5;12,19,26,33,34;47,46,45,44,43,42,35,28;21,14,15,8,9,10,3;4,11,18,17,24,31,38,37,36,29,22
8,0,1,8,33:46;40,32,33,34,42,43,44,45,46,47,55,63,62,61,60,59,58,57;28,20,21,22,30;8,0,1,2;9,10,18,26,25,33,41;24,16,17;31,39,38,46,54,53,52,51,50,49,48,56;29,37,36,35,27,19,11,12,13,14;3,4,5,6,7,15,23
8,0,2,7,29:18;13,14,22;42,34,26,18,10,9;45,44,52,60,59,58,57,56,48,40,32;24,25,33,41,49,50,51,43,35,36,37,29,21,20;16,8,0,1,2,3;11,12,4,5,6,7,15,23,31,39,47,55,63,62,61;17,18,19,27,28,29,30,38,46,54,53
8,0,3,8,44:33;17,16,8,0;1,9,10,18,26,27,35,36,44,52,53,54,46,38,30,22,21,13,12,4;2,3,11,19,20,28,29,37,45,44,43,42,34,33,32,24;40,41,33,25;14,6,5;49,50,51;31,23,15,7;39,47,55,63,62,61,60,59,58,57,56,48
8,0,4,7,18;1,2,10,18,26,25;37,29,21,13,14;54,53,52,51,50,49,41,33,34;9,17,18,19,27;0,8,16,24,32,40,48,56,57,58,59,60,61,62,63,55,47,39,31,23,15,7,6,5,4,3;11,12,20,28,36,35,43,42;44,45,46,38,30,22
8,0,5,7,35;49,50,42,34,35,36,28,20,19,11,10,9,1,0;2,3,4,5,6,7,15;21,29,30,38,46,54,53;12,13,14,22,23,31,39,47,55,63,62,61,60,52,44,45,37;51,59,58,57,56,48,40,32,24,16,8;17,18,26,27,35,43;41,33,25
8,0,6,8,52;13,12,11,10,9;63,55,47,39,31,23,15,7,6,5,4,3,2,1,0,8,16,24,25,26,34;61,53,52,51,43,35;62,54,46,38,30,22,14;45,37,29,21,20,19,18,17;41,49,57,56;48,40,32,33;42,50,58,59,60,52,44,36,28,27
8,0,7,7,20:49;56,57,49,41,33;3,11,12,20,28,27,26,25,17,9;35,43,51,52,53,45,46,38,30,22,14,13;44,36,37,29,21,20,19,18,10,2,1,0;4,5,6,7,15,23,31,39,47,55,63;34,42,50,49,48,40,32,24,16,8;54,62,61,60,59,58
8,0,8,8,51;58,57,56,48,40,32,24;13,14,22,30,31,39,47,55,63;23,15,7,6;9,10,11,12,20,21,29,37,38,46;35,34,26,25;52,51,50,49;54,62,61,60,59,51,43,42,41,33;5,4,3,2,1,0,8,16,17,18,19,27,28,36,44,45,53
8,0,9,7,35:38;59,51,50,42,34,35,36,28,20,19,11,10,9;0,8,16,17,18,26,27,35,43;58,57,56,48,40,32;12,13,21,29,37,38,39,31,23,15,7;49,41,33,25,24;44,45,53,54;52,60,61,62,63,55,47,46,38,30,22,14,6,5,4,3,2,1
8,0,10,8,42:14;28,29,37,45,44,52,51;43,42,41;5,4,12;7,6,14,22,30,38,46,54,53;48,40,32,24,16,8,0,1,2,3;61,62,63,55,47,39,31,23,15,14,13,21,20,19,11,10,9,17,25,33,34,42,50,49;60,59,58,57,56;18,26,27,35,36
8,0,11,6,14;20,12,11,10,9,17,25,33,41,49,50,51,52,53,54;7,15,14,13,21;46,45,44,43,42;39,38,37,36,35,34,26;22,14,6,5,4,3,2,1,0,8,16,24,32,40,48,56,57,58,59,60,61,62,63,55,47;23,31,30,29,28,27,19,18
8,0,12,6,20:38;29,21,20,19,27,35,36,44;31,23,15,7,6;16,24,25,33,41,49,50,51,52,53,54,46,38,30,22,14,13,5,4,3,2,1;32,40,48,56,57,58,59,60,61,62,63,55,47,39,38,37,45;28,20,12,11,10;43,42,34,26,18,17,9,8,0
8,0,13,8,13;27,26,18,17;48,56,57,58,59,60,52,44,36,28,20,19,11,10,9;6,7,15,23,31,39,47,55,63;54,46,38,30,22,14,13,12;51,50,49;32,40,41,42,43;24,25,33,34,35;62,61,53,45,37,29,21,13,5,4,3,2,1,0,8,16
8,0,14,6,21:10;49,41,33,25,17,18,10,2,3,4,5,6,14,22,21,20,28,36,35,43,51;12,13,21,29,37,45;50,42,34,26,27,19,11,10,9;57,56,48,40,32,24,16,8,0,1;39,47,55,63,62,61,60,59,58;7,15,23,31,30,38,46,54,53,52,44
8,0,15,8,27:14;62,54,46,45,37,36,35,27,19,20,12,4,5;61,53,52,44,43,42,34,26,27,28,29;21,13,14,15,23,31,30;22,14,6,7;9,8,16,24,32,40,48,56,57,58,59,60;51,50,49,41,33,25,17,18,10;63,55,47,39,38;11,3,2,1,0
8,0,16,7,46:25;49,41,42,43,44,36;14,22,21,20,19,18,26,25,24,16;39,31,30,29,28,27,35,34,33,25,17,9,10,11,12,13,5;6,7,15,23;32,40,48,56,57,58,50,51,52,53,54,46,38;8,0,1,2,3,4;37,45,46,47,55,63,62,61,60,59
8,0,17,8,34:54;48,56,57,58;18,26,34,42,43,44,45,37;17,9,10,11,19,27;36,28,20,12,13,14,22;23,15,7,6,5,4,3,2,1,0,8,16,24,25,33,34,35;52,53,54,55,63;31,39,47,46,54,62,61,60,59,51,50,49,41,40,32;21,29,30,38
8,0,18,7,36;32,24,16,8,0,1,2,3,4,5,6,7,15;49,50,51,52;57,56,48,40,41,42,43;54,53,45,44,36,28,27,26,25,17,9,10,11,12,13,14;46,47,55,63,62,61,60,59,58;30,29,21,20,19,18;22,23,31,39,38,37,36,35,34,33
8,0,19,6,28;44,36,28,20,21,22,14,6;12,11,19,18,26,34,42;13,5,4,3,2,1,0,8,16,24,32,40,48,56,57,58,59,60,61,62,54,46,38;63,55,47,39,31,30,29,28,27,35,43;37,45,53,52,51,50,49,41,33,25,17,9,10;23,15,7
8,0,20,7,27;51,50,49,41,33,25;7,6,5,4,3,2,1,0,8,16,17,18,19,27,35,36,44,52,53,54;13,14,15,23,31,30,38;39,47,46;9,10,11,12,20,21,22;43,42,34,26,27,28,29,37,45;55,63,62,61,60,59,58,57,56,48,40,32,24
8,0,21,8,46;14,13,12,11,10,9,8,0;51,52,53,45,46,47,55;37,36,44,43,42,50;57,49,41,33,34,35;1,2,3,4,5,6,7,15,23,31,39,38,46,54;30,29,28,27,26,25,24,32,40,48,56;22,21,20,19,18,17,16;63,62,61,60,59,58
8,0,22,6,13;17,9,10;4,3,2,1,0,8,16,24,32,40,48,56;31,23,15,7,6,5,13,21,20,28,36,44;29,30,22,14,13,12,11,19,18,26,25,33,41,49,57;46,54,53,52,51,43,35,27;45,37,38,39,47,55,63,62,61,60,59,58,50,42,34
8,0,23,7,53;40,48,56,57,58;25,17,18,19,20,28,29,37;60,59,51,50,49,41,33,32;45,53,61,62,63,55,47,39,31,23,15,14;0,1,2,3,4,5,6,7;36,35,27;24,16,8,9,10,11,12,13,21,22,30,38,46,54,53,52,44,43,42,34,26
8,0,24,7,35;25,24,32,40,41,49,50,51,52,44,45,37,29,21;17,16,8,0,1,2,3,4,5,6;18,19,20,28,36,35,34,33;53,54,46,38,30,22,14,13,12,11,10,9;42,43,35,27,26;61,62,63,55,47,39,31,23,15,7;48,56,57,58,59,60
8,0,25,6,29;35,43,42,41,40,32,24,16,8,0,1,2,3,4,5,6,7,15,23,31,39;63,55,54,53,45,44,36;62,61,60,52,51,50,49;34,26,18,19,20,21,29,37,38,46,47;59,58,57,56,48;27,28,29,30,22,14,13,12,11,10,9,17,25,33
8,0,26,8,12;38,30,22,14,6,5;37,36,28,20,12,4,3,2,1,9,17,25,33,41,49,50,51;7,15,23,31,39,47,55,63,62,61,60,52;59,58,57,56,48,40,32;42,34,26,18,10;45,44,43,35,27,19,11,12,13,21,29;0,8,16,24;53,54,46
8,0,27,7,29;63,62,61,53,45,46,38;36,28,29,30,22,14,13,12,11,10,9,17,25,33,41,49;31,23,15,7,6,5,4,3,2,1,0,8,16,24,32,40,48,56,57,58,59,60,52,44;54,55,47,39;51,43,35,27,26,18;50,42,34;37,29,21,20,19
8,0,28,7,37;8,16,24,32;23,15,7,6,5;22,30,31,39,47,55,63,62,61,60;49,50,51,52,53,54,46,38,37,36,28,20,12,4;9,10,18,26,34,42,41,40,48,56,57,58,59;0,1,2,3,11,19,27,35,43,44,45,37,29,21,13,14;17,25,33
8,0,29,7,42:21;54,46,38,30,22,21,20,19,27,35,34,42,50,51;18,26,25,33;52,53,61,62,63,55,47,39,31,23,15,14;60,59,58,57,56,48,40,32,24,16,17,9,10,11,12,13,21,29,28,36;44,45,37;43,42,41,49;8,0,1,2,3,4,5,6,7
8,0,30,6,20;43,42,50,49;33,32,24,16,8,0;18,10,11,12,20,28,29,37,45;14,13,5,4,3,2,1,9,17,25,26,34,35,36,44,52,51;6,7,15,23,31,39,47,55,63,62,61,60,59,58,57,56,48,40,41;27,19,20,21,22,30,38,46,54,53
9,0,1,8,46:31:25;70,69,78,77,76,75,74,73,72,63,54,55,46,37,28;9,0,1,2,3,4,5,6,7,8,17,26,25,24,23,32,31,30,29;59,68,67,66,65,64;33,42,43,52,53;44,35,34,25,16,15,14,13,12,11,10,19,18,27,36,45,46,47,56,57,58,49;38,39,48;20,21,22,31,40,41,50,51;60,61,62,71,80,79
9,0,2,8,28:61;11,12,13;49,50,51,52,61,70,69,68,67,66,65,64,55,46;8,7,6,15,24,33,32,31,30,39,48,47;56,57,58,59,60,61,62,71,80,79,78,77,76,75,74,73,72,63,54,45,36;0,9,18,27,28,29,20,21,22,23,14,5;16,17,26,35,44,53;25,34,43,42,41,40;4,3,2,1,10,19,28,37,38
9,0,3,8,30;46,55,56,57,48;8,7,6,5,4,3,2,1,0,9,18,27,36,45,54,63,64,65,66,67,58,49,50,41,32,33,34,43,52,61,70;26,35,44,53,62,71,80,79,78,69;42,51,60,59,68,77,76,75,74,73,72;31,30,29,20,11,12,13,14,15,24;47,38,37,28,19,10;23,22,21,30,39,40;25,16,17
9,0,4,10,66:52;18,27,36,45,54;63,64,55,56,47,48,49,58;10,19,28,37,46;11,20,29,38,39,40,41,50,59;12,21,30,31,32,33,42;57,66,75;68,69,70;72,73,74,65,66,67,76,77,78,79,80,71,62,61,52,43,34,25,16,15,14,5;60,51,52,53,44,35,26,17,8,7,6;24,23,22,13,4,3,2,1,0,9
9,0,5,8,37;67,66,65,74,73,72,63,54,45,36,37,38,39,40,41,42,43;47,46,37,28,27,18,9,0,1,2,3,4,5,6,7,8,17,26,35,44,53,52;19,10,11,12,13,14,15,16,25,34,33,32,31,30;29,20,21,22,23,24;70,69,68,59,58,57,56,55,64;61,62,71;80,79,78,77,76,75;48,49,50,51,60
9,0,6,9,65;43,42,51,60,59,68,67;69,70,61,52;20,21,30,31;24,23,14;22,13,12,11,10,19,28,37,46,55,64,65,66,57,58,49,50,41,32,33,34,25,16,15;3,2,1,0,9,18,27,36,45,54,63,72,73,74,65,56,47,48;78,79,80,71,62,53,44,35,26,17,8,7,6,5,4;29,38,39,40;75,76,77
9,0,7,9,52;2,1,0,9,18,27,36,45,54,63,72,73,74,65,56,47,38,29,20,21,22,13;30,39,48,57,66,75,76,77,78,69,70;40,49,58;67,68,59,60,61,52,43,42,33,24,23;79,80,71,62;6,7,8,17,26;31,32,41,50;64,55,46,37,28,19,10,11,12,3,4,5,14,15,16,25,34,35;44,53,52,51
9,0,8,9,70;71,70,69,78,77,76,75,74,73,64,55,46;67,68,59,60,51,52,43,34;66,65,56,47,38,37,28,19,10,11,12,21,22,23,24,33;50,49,40;25,16,15,14,13;45,54,63,72;36,27,18,9,0,1,2,3,4,5,6,7,8,17,26,35,44,53,62,61,70,79,80;20,29,30,31,32,41,42;39,48,57,58
9,0,9,8,14:29;48,47,56,55,54;36,27,18,19,10,11,12,13,14,15,24,33,42,51,60;79,80,71,62,53,44,35,26,17,8,7,6;16,25,34,43;9,0,1,2,3,4,5,14,23,22,21,20,29,38,39,40,49,58,57,66,65,64;63,72,73,74,75,76,77;67,68,59,50,41,32,31,30,29,28,37,46,45;52,61,70,69,78
9,0,10,9,20:16;36,37,38,39,30,31,32,33,34;70,69,68,67,66,65,64;27,28,29,20,11,10;41,42,43,52,53;8,17,16,15,14,13,12,3,2,1,0,9,18;60,61,62,71,80,79,78,77,76,75,74,73,72,63,54,45,46,47,48,49,40;4,5,6,7,16,25,24,23,22,21,20,19;51,50,59,58,57,56,55;44,35,26
9,0,11,10,20:52;30,29,20,11,12,13,22,23;50,59,68;80,71,62,53,52,51,42,41;60,69,78,77,76,75,74,73,72,63,54,55,56,57,48,39;38,37,28;21,20,19,10;3,2,1,0,9,18,27,36,45,46,47;24,33,32,31,40,49,58,67,66,65,64;4,5,6,7,8,17,26,35,44,43,52,61,70,79;14,15,16,25,34
9,0,12,9,33;64,65,66,67,58,49,50;9,18,27,36,45,54,63,72,73,74,75,76,77;55,56,57,48,39,40,41,42,33,24,15,14,13,12,11,10,19,28,37;17,16,25,34,33,32,23,22,21,20;46,47,38,29,30,31;8,7,6,5,4,3,2,1,0;78,79,80,71;69,70,61,62,53;68,59,60,51,52,43,44,35,26
9,0,13,8,15;31,30,29,38,47;46,45,36,27,18,9,0,1,2,3,4,5,14,15,16,25,34,43;52,51,50,41,32,23,22,13,12,11,10;21,20,19,28,37;48,57,56,55,64,73,74,75,76,77,78,79,80,71,62,53,44,35,26,17,8,7,6,15,24,33,42;60,59,58,49,40,39;54,63,72;61,70,69,68,67,66,65
9,0,14,9,19;27,36,45,54;78,79,80,71,62,53,44,35,26,17,8,7,6,5,14;57,56,55,46,37,28,19,10,11,12,21,30,31,32;50,41,40,39,38,29,20,19,18,9,0,1,2,3,4,13,22,23;47,48,49,58,59,68,77;15,24,33,42,51,60,69,70;67,66,65,64,63;72,73,74,75,76;61,52,43,34,25,16
9,0,15,7,30:69;12,11,10;49,40,41,42,43,52,61,70,69,68,77,76,75,74;45,46,47,38,29,30,31,22,13,14,15,16;72,63,54,55,56,57,48,39,30,21,20,19,28,37;73,64,65,66,67,58,59,50,51;33,34,35,44,53,62,71,80,79,78,69,60;32,23,24,25,26,17,8,7,6,5,4,3,2,1,0,9,18,27,36
9,0,16,9,60:30;71,62,53,44,35,26,17,16,15,14;41,40,39,30,21;64,65,66,67,68,69,60,51,52;47,48,49,50;5,6,7,8;34,25,24,23,22,13,12,11,10,19,28,27,36,45,54,63,72,73,74,75,76,77,78;38,37,46,55,56,57,58,59,60,61,70,79,80;18,9,0,1,2,3,4;43,42,33,32,31,30,29,20
9,0,17,9,20;30,29,20,11,12,13,14,15,16,25,34,43,52,61,70,69,68,67,66;48,47,46;18,9,0;39,38,37,28;65,74,75,76,77,78,79,80,71,62,53,44,35,26,17,8,7,6,5,4,3,2,1,10;60,51,42,33,24,23,22,21,20,19;63,54,45,36,27;59,50,41,32;31,40,49,58,57,56,55,64,73,72
9,0,18,9,16:40:37;51,50,41,40,39,48,47,56,55;42,33,24,15,16,17,8;11,12,13,14,23,32,31,40,49;26,35,44;64,65,66,67,68,69,70,61;3,4,5,6,7,16,25,34,43,52,53,62,71,80,79,78,77,76,75,74,73,72,63,54,45,36,37,38,29,30;57,58,59,60;2,1,0,9,18,27,28,37,46;10,19,20,21,22
9,0,19,7,21;69,70,61,52,43,34,25,16,15,14,13;0,1,2,3,4,5,6,7,8,17,26,35,44,53,62,71,80,79,78;40,39,48,57,66,67;68,77,76,75,74,73,72,63,54,45,36,27,18,9,10,11,12,21,30,29,38,47,56;58,59,60;65,64,55,46,37,28,19,20,21,22,31,32,41,50,49;51,42,33,24,23
9,0,20,8,38;12,13,14,15,16,25;54,63,64,65,66,67,58,49,50;1,2,3,4,5,6,7,8,17,26,35,44,53,62,71,80,79;72,73,74,75,76,77,68,59,60,51,42,41,32,31,30,29,38,47,46;78,69,70,61,52,43,34,33,24,23,22,21,20,11;0,9,10,19,28,37,38,39,40;55,56,57,48;45,36,27,18
9,0,21,9,46:41;9,18,27,36,37,46,55,56,57,66,75,76;67,58,59,60,51,52;25,16,15,14,13,12,21,20;26,35,34,33,24,23,22,31,30;11,10,19,28,29,38,39,40,41,42,43,44,53,62,71,80,79,78,77;0,1,2,3,4,5,6,7,8,17;68,69,70,61;73,72,63,54,45,46,47,48,49,50,41,32;64,65,74
9,0,22,8,28:69;64,65,56;77,76,67,66,57;48,47,46,55;0,9,18,27,28,29,20,11,12,13,14,15,16,25,34,43;38,39,30,21,22,23,24;75,74,73,72,63,54,45,36,37,28,19,10,1,2,3,4,5,6,7,8,17,26,35,44,53,62,61,60,69,78,79,80;58,49,40,31,32,33,42,51,52;71,70,69,68,59,50,41
9,0,23,9,28;7,16,25,24,23,22,21,20,11,10;42,51,52,61,70,71;8,17,26,35,34,33,32,41,50,59,60,69;38,47,46,55,64,65,66,75,76;80,79,78,77,68,67,58,49,40,31,30,29,28,27,36,45,54,63,72,73,74;56,57,48,39;12,13,14,15;37,28,19,18,9,0,1,2,3,4,5,6;43,44,53,62
9,0,24,9,69:37;48,39,38,37,36,27,18,9,0;60,69,78,77,76,75,74,73,72,63,54,45,46,37,28;53,52,51,42,33,24,23,22,21,12,11;35,26,17,8,7,6,5;79,80,71,62,61;47,56,57,66,67,68,69,70;55,64,65;58,49,40,31,30,29,20,19,10,1,2,3,4,13,14,15,16,25,34,43,44;59,50,41,32
9,0,25,7,47:32;20,19,28,37,46,47,48,49,50,59;16,25,34,43,42,51,60;54,55,64,65,66,67,68,69,70,61,52,53,44,35,26,17,8,7,6,5,4,3,2,1,0;39,40,41,32,23,22;45,36,27,18,9,10,11,12,13,14,15,24,33,32,31;58,57,56,47,38,29,30,21;63,72,73,74,75,76,77,78,79,80,71,62
9,0,26,9,59:65;79,80,71,62,53,44,43,34,25,16,15;5,6,7,8,17,26,35;4,3,2,1,0,9,18,27,36,45,54,63,72;60,59,58,57,48,47,38,29;74,65,56,55,46,37,28,19;20,21,30,39,40,49,50,59,68;67,76,77,78,69,70,61,52,51,42,33,24,23,14;73,64,65,66,75;41,32,31,22,13,12,11,10
9,0,27,10,68:37;48,49,50,51,60,69,68,67,66,65,64,63;78,79,80,71,62,53,44;72,73,74,75,76,77,68,59,58,57;21,22,23,24,33;39,40,41,42,43,52,61,70;32,31,30,29,20,11,12,13,14,15;10,19,28,37,46;35,26,17,8;45,54,55,56;47,38,37,36,27,18,9,0,1,2,3,4,5,6,7,16,25,34
9,0,28,7,51;20,21,22,23,14,15;49,40,41,32,33,24;16,25,34,43,42,51,60,59,58,57,48,39,30,31;13,12,11,10,19,28,29;46,55,64,65,66,67,68,69,70,61,52,51,50;72,73,74,75,76,77,78,79,80,71,62,53,44,35,26,17,8,7,6,5,4,3,2,1,0,9,18,27;63,54,45,36,37,38,47,56
9,0,29,8,59:38;31,30,21,12,11,10;19,20,29,38,47,56,65,74,75,76,77,78,69,70,61;32,23,22,13,4,5,6,7,8,17,26,35;54,63,72,73;44,43,34,25,16;3,2,1,0,9,18,27,36,45,46,55,64;14,15,24,33,42,41,40,49,58,59,60;28,37,38,39,48,57,66,67,68,59,50,51,52,53,62,71,80,79
9,0,30,8,48;28,37,46,55,64;25,24,23,32,31,30;16,15,14,13,22,21,20,29,38,47,48,49,50,51,60,69,78,79,80,71,62,53,44;12,11,10,19;70,61,52,43,34,35,26;65,56,57,48,39,40,41,42,33;68,77,76,75,74,73,72,63,54,45,36,27,18,9,0,1,2,3,4,5,6,7,8,17;66,67,58,59
