5,0,1,4;9,4,3,2,1;7,6,5,0;16,17,18,19,14;8,13,12,11,10,15,20,21,22,23,24
5,0,2,4;0,5,10,15,20;18,13,8,3,4;17,12,7;9,14,19,24,23,22,21,16,11,6,1,2
5,0,3,4;20,21,22,23;24,19,14,9,4,3;18,17,12,11,6;13,8,7,2,1,0,5,10,15,16
5,0,4,5;4,9,14,13;19,24,23,22,21,16;6,7,8,3;11,12,17,18;20,15,10,5,0,1,2
5,0,5,5;23,18,13;15,20,21,22,17,12;2,1,0,5,10;3,4,9,14,19,24;8,7,6,11,16
5,0,6,5;8,13,18;5,6,11,12,17;20,15,10;0,1,2,7;16,21,22,23,24,19,14,9,4,3
5,0,7,4;24,23,22,21,20,15,10,5,0,1;8,13,12;6,7,2,3,4,9,14,19;18,17,16,11
5,0,8,3;15,10,5,0,1,2,3,4,9,14,19;20,21,16,11,6,7,8,13,18;24,23,22,17,12
5,0,9,4;8,13,18,17,16,11,10,5;9,14,19,24,23,22,21,20,15;12,7,6;0,1,2,3,4
5,0,10,4;2,1,0,5,10,15,20,21;12,17,22,23,24,19,14,9,4,3;6,11,16;18,13,8,7
5,0,11,3;3,4,9,14,19,24,23,22,21,20,15,10,5;12,11,6,1,0;2,7,8,13,18,17,16
5,0,12,4;16,17,18;19,24,23,22,21,20,15,10,11,12,13;4,3,2,1;14,9,8,7,6,5,0
5,0,13,4;15,10,11,6;8,13,18,23,22;24,19,14,9,4,3,2,7,12,17,16,21,20;5,0,1
5,0,14,4;23,22,21,20,15,10,11,12,13,14,9;16,17,18,19,24;8,7,6;4,3,2,1,0,5
5,0,15,4;24,23,22,21,20,15,10,5,0,1,2,3,4;11,12,13;19,18,17,16;6,7,8,9,14
5,0,16,4;6,7,2,3;18,17,16;4,9,14,19,24,23,22,21,20,15,10,5,0,1;8,13,12,11
5,0,17,4;15,10,5,0,1,2,3,4,9,14,13;16,11,6,7,8;19,24,23,22,21,20;18,17,12
5,0,18,4;23,18,13,8;24,19,14,9,4,3,2,1;10,15,20,21,22,17,12,7;0,5,6,11,16
5,0,19,5;21,22,17,12,7;6,11,16,15,20;19,14,9,4,3,2;1,0,5,10;8,13,18,23,24
5,0,20,4;18,13,8,3,4;9,14,19,24,23,22,21,20;1,2,7,12,17,16,15,10;0,5,6,11
5,0,21,4;15,10,5,0,1,2,3,4,9,14;6,7,8,13,18;20,21,16;19,24,23,22,17,12,11
5,0,22,4;23,24,19,14,9,4,3,2;5,10,15,20,21,22,17,18,13,8;16,11,12;7,6,1,0
5,0,23,4;6,7,12,17;8,13,18;15,20,21,22,23,24,19,14,9,4,3,2,1,0;16,11,10,5
5,0,24,5;1,6,7,12,17,22,21;24,23,18,13,8,3,2;19,14,9,4;0,5,10;20,15,16,11
5,0,25,3;19,18,17,16,11,6,7,8,3,4;24,23,22,21,20,15,10,5,0,1,2;9,14,13,12
5,0,26,5;14,9,4,3,2;24,23,22,21,20,15;6,7,8,13;1,0,5,10,11,16;12,17,18,19
5,0,27,4;6,11,16;22,21,20,15,10,5,0,1;18,13,8;17,12,7,2,3,4,9,14,19,24,23
5,0,28,6;8,13,18;16,11,6;21,20,15,10;7,12,17;3,4,9,14,19,24,23,22;5,0,1,2
5,0,29,4;2,3,4,9;13,14,19,24,23,22,21,20,15,10,5,0,1;16,11,6;18,17,12,7,8
5,0,30,3;1,0,5,10,11,12;2,3,4,9,14,19,24,23,22,21;6,7,8,13,18,17,16,15,20
5,0,31,3;1,0,5,10,15,20,21,22,23,24,19,14,9,4;6,11,16,17,18,13,8,3;12,7,2
5,0,32,5;2,3,4,9,14,19,24,23,22;21,20,15,10,5,0;1,6,7,8;18,17,16;11,12,13
5,0,33,4;0,1,6;13,18,17,16;8,9,14,19,24,23,22,21,20,15;5,10,11,12,7,2,3,4
5,0,34,5;0,1,6;18,17,16;11,12,7,2,3;13,14,19,24,23,22,21,20,15,10,5;8,9,4
5,0,35,5;10,15,20,21,22,23,24,19,14,9;8,7,12;0,5,6,11,16;4,3,2,1;17,18,13
5,0,36,3;20,21,22,23,24,19,14,9,4,3;1,6,11,12;0,5,10,15,16,17,18,13,8,7,2
5,0,37,5;20,15,10;5,0,1,2,3,4,9,14,19,24,23;17,22,21;12,11,16;6,7,8,13,18
5,0,38,4;22,23,24,19,14,13,8;9,4,3,2,1,0,5,10,15;6,11,16,21,20;18,17,12,7
5,0,39,4;24,23,22,21,20;18,17,12,11,6,1,2,3,4,9;16,15,10,5,0;7,8,13,14,19
5,0,40,3;0,5,10,15,20,21,22,23,24,19,14;4,3,2,1,6,11,16,17,18,13;9,8,7,12
5,0,41,5;23,22,17;21,16,11,6;18,19,24;4,9,14,13,12,7;20,15,10,5,0,1,2,3,8
5,0,42,5;5,6,11,16,17;24,23,22,21,20,15,10;12,7,2,1,0;3,4,9,14;19,18,13,8
5,0,43,4;23,22,21,20;0,1,2,3,4,9,14,13;24,19,18,17,12,11;16,15,10,5,6,7,8
5,0,44,3;15,10,11,12,17,22,23,24,19,14,9,4,3,2,1,0;16,21,20;18,13,8,7,6,5
5,0,45,4;3,2,1;11,16,17,18,13,8,9,4;0,5,10,15,20,21,22,23,24,19,14;6,7,12
5,0,46,4;19,14,9,4,3,2,1,0,5,10,15,20;7,8,13;22,21,16;6,11,12,17,18,23,24
5,0,47,4;8,13,18;16,11,6,1,0;2,3,4,9,14,19,24,23;7,12,17,22,21,20,15,10,5
5,0,48,3;7,6,11,16,17,18,19,14;12,13,8;9,4,3,2,1,0,5,10,15,20,21,22,23,24
5,0,49,4;0,1,6;12,11,10,5;2,7,8,13,18,17,16;3,4,9,14,19,24,23,22,21,20,15
5,0,50,4;15,10,5,0,1,2,7,12,17,22;23,18,13,8;6,11,16,21,20;24,19,14,9,4,3
5,0,51,5;21,20,15;6,7,8,3;24,19,18,13,12,11,10,5,0,1,2;23,22,17,16;4,9,14
5,0,52,5;5,10,11;18,13,8,7,6,1,0;20,15,16,17,12;21,22,23,24;19,14,9,4,3,2
5,0,53,4;3,8,13,12;24,23,18,17,16,11,6,7,2;22,21,20,15,10,5,0,1;4,9,14,19
5,0,54,5;4,3,2;14,19,24,23,22,21,20,15;5,10,11,12,13;16,17,18;0,1,6,7,8,9
5,0,55,5;4,3,8,7,6,5;9,14,19,24,23,22;0,1,2;16,17,18,13;21,20,15,10,11,12
5,0,56,5;3,8,7,6,11,16,21;13,12,17,22,23;24,19,18;14,9,4;2,1,0,5,10,15,20
5,0,57,4;16,17,18;10,5,0,1,2,3,4,9;15,20,21,22,23,24,19,14,13,12,11;8,7,6
5,0,58,4;19,18,13,12,11,10,15,20,21;14,9,8,7,6,5;4,3,2,1,0;16,17,22,23,24
5,0,59,5;1,2,7,8;0,5,6,11,12,13,14,19,24,23,22;18,17,16,21;3,4,9;20,15,10
5,0,60,5;1,0,5,10,15,20,21,22,17;2,7,6,11,16;24,23,18;12,13,8,3;19,14,9,4
6,0,1,5;2,8,9,15,21;1,7,13,14,20,26,25,24;19,18,12,6,0;30,31,32,33,27,28,22,16,10;34,35,29,23,17,11,5,4,3
6,0,2,5;6,7,8,14,15,21,27;31,30,24,18,12;0,1,2,3,4,5,11,17,23,29,35,34,33,32,26,20;9,10,16,22,28;25,19,13
6,0,3,5;15,21,27,28;35,34,33,32;24,18,12,6,0;22,16,10,9,8,14,20,26,25,31,30;29,23,17,11,5,4,3,2,1,7,13,19
6,0,4,5;19,25,26,32,33,34,35;7,13,14,15,16,22;10,9,8;20,21,27,28,29,23,17,11,5,4,3,2,1;0,6,12,18,24,30,31
6,0,5,5;8,9,10,16,17,23,29,35;26,27,28;34,33,32,31,25,19,20;30,24,18,12,6,0,1,2,3,4,5,11;22,21,15,14,13,7
6,0,6,5;0,1,2,3,9,15,21,20,26,25;12,6,7,8;4,5,11,17,23,29,35,34,33,32,31,30,24,18;19,13,14;10,16,22,28,27
6,0,7,5;16,17,11,5,4,3,2,1,0,6,12,18,24,30,31,32,33,34,35;25,26,20,21,22;8,7,13,19;27,28,29,23;10,9,15,14
6,0,8,4;35,29,28,22,16,15,14,13,19,25,26,32;34,33,27,21,20;31,30,24,18,12,6,0,1,2,3,4,5,11,17,23;7,8,9,10
6,0,9,6;12,18,19,20,21,22,23,17;5,4,3;11,10,9,8,2,1,0;24,30,31,32,33,34,35;25,26,27,28,29;16,15,14,13,7,6
6,0,10,5;27,26,20,14,8,2,1;28,22,21,15;3,4,5,11;7,13,19,25;0,6,12,18,24,30,31,32,33,34,35,29,23,17,16,10,9
6,0,11,4;34,35,29,23,22,16,15,14,20;26,25,19,13,7,8,9,10,11,17;33,32,31,30,24,18,12,6,0,1,2,3,4,5;28,27,21
6,0,12,6;13,19,25,24;14,20,26,27;30,31,32,33;28,22,21,15,9,8,7;11,5,4,3,2,1,0,6,12,18;34,35,29,23,17,16,10
6,0,13,4;28,22,16,10;0,1,2,8,14,20;15,9,3,4,5,11,17,23,29,35,34,33,32,31,30,24,18,12;6,7,13,19,25,26,27,21
6,0,14,6;22,28,27;0,6,7,8,9,15,21,20,19;24,18,12,13,14;26,32,33,34,35,29,23,17,11,5;30,31,25;16,10,4,3,2,1
6,0,15,6;28,22,21,15,9,3,4;1,7,13,19,20,26,27;25,31,32,33,34,35,29,23,17,16;5,11,10;0,6,12,18,24,30;14,8,2
6,0,16,6;3,4,5,11,17,23,29;16,10,9;24,30,31,32;20,19,13,7;28,22,21,15,14,8,2,1,0,6,12,18;25,26,27,33,34,35
6,0,17,6;14,8,2,3,4,5;21,15,9,10;11,17,23,29,35,34,33;1,7,13,19,20,26,32,31,30;27,28,22,16;25,24,18,12,6,0
6,0,18,4;28,27,26,25,24,18,12;1,2,8;30,31,32,33,34,35,29,23,17,11,5,4,3,9,15,14;10,16,22,21,20,19,13,7,6,0
6,0,19,5;26,20,14;5,11,17,23,29,35,34;25,19,13,7,8;30,31,32,33,27,21,15,9;24,18,12,6,0,1,2,3,4,10,16,22,28
6,0,20,6;0,1,7,8,9,10,16,22,28,29;24,18,12,6;35,34,33,27,21,20,19,25;30,31,32,26;2,3,4,5,11,17,23;13,14,15
6,0,21,4;25,26,27,21,22,23,29,35;10,9,8,7,13,12;6,0,1,2,3,4,5,11,17,16,15,14,20,19,18;24,30,31,32,33,34,28
6,0,22,6;28,22,16,10,9,3,2,1,0;20,14,8,7,6,12,18;13,19,25,24,30;33,34,35;29,23,17,11,5,4;31,32,26,27,21,15
6,0,23,4;28,22,16,10,9;25,24,18,12,6,0,1,2,3,4,5,11,17,23;7,13,19,20,26,32,31,30;29,35,34,33,27,21,15,14,8
6,0,24,5;16,10,9,8;20,21,22,28,34,33,32,31,30,24,18,12,6,0;19,25,26,27;1,7,13,14,15;35,29,23,17,11,5,4,3,2
6,0,25,6;0,6,7,8,9,10,11,17,23,29,35;16,15,14,20;13,19,25,26,27,21,22;1,2,3,4,5;30,24,18,12;31,32,33,34,28
6,0,26,5;10,16,15,21;25,26,20,14,8,9;22,28,27,33,32,31,30,24;13,7,1,2,3,4,5,11,17,23,29,35,34;19,18,12,6,0
6,0,27,5;14,13,12,18,24,30,31,32,33,34,35,29;19,25,26,27,28;5,11,17,23,22;16,10,4,3,2,1,0;20,21,15,9,8,7,6
6,0,28,4;25,26,27,28,22;9,15,21,20,19,13,7,1;11,5,4,3,2,8,14;10,16,17,23,29,35,34,33,32,31,30,24,18,12,6,0
6,0,29,6;7,13,19;14,20,26,25;17,16,10,9,8;11,5,4,3,2,1,0,6,12,18,24,30,31,32,33,34,35;15,21,22,23;29,28,27
6,0,30,5;4,10,9,8,7,6,12,18,24,30,31,32;5,11,17,16,15,14,13,19,25,26,27,28;20,21,22;33,34,35,29,23;0,1,2,3
6,0,31,4;11,10,9,8,14;24,30,31,32,33,34,35,29,23,17,16,15,21,20;5,4,3,2,1,7,13;0,6,12,18,19,25,26,27,28,22
6,0,32,4;30,31,25;27,21,15,14,13,12,6;0,1,2,3,4,5,11,17,23,29,35,34,33,32,26,20,19,18,24;7,8,9,10,16,22,28
6,0,33,5;7,8,9,10;17,11,5,4,3,2,1,0,6,12,13,14,20,21;23,29,35,34,33,32,31,30,24,18;19,25,26;15,16,22,28,27
6,0,34,6;13,7,8,9;21,27,26;16,22,28,34,33,32;31,30,24,18,12,6,0,1,2,3,4,10;25,19,20,14,15;35,29,23,17,11,5
6,0,35,5;27,28,29,23,17,11,5,4,3,2,1,0,6,12,18,24,30;33,34,35;10,16,22,21;32,31,25,19,13,7,8,9;15,14,20,26
6,0,36,4;29,23,22,16,15,14,13,19,25,26;5,4,3,2,1,0;17,11,10,9,8,7,6,12,18,24,30,31,32,33;20,21,27,28,34,35
6,0,37,5;35,34,33,27,26,25;0,6,12,13,14,15,16,17,23,29;28,22,21,20,19,18,24,30,31,32;11,10,9,8;5,4,3,2,1,7
6,0,38,5;24,30,31,32,33,34,28,22,16,10,9,3,2;15,21,27,26,25;6,12,18,19,20,14,8;0,1,7,13;35,29,23,17,11,5,4
6,0,39,5;11,17,23;29,28,22,16,10,4,5;27,26,25,19,13,7,1,2,3,9,15;8,14,20,21;35,34,33,32,31,30,24,18,12,6,0
6,0,40,4;34,35,29,23,17,11,5,4;30,31,32,26,20,19,13,12,6,0,1,2,3,9,10,16,22,28;7,8,14,15,21,27,33;25,24,18
6,0,41,4;25,26,27,28,22,16,10,9,8,2,1,0;7,13,14;24,30,31,32,33,34,35,29,23,17,11,5,4,3;6,12,18,19,20,21,15
6,0,42,4;35,29,23,17,11,5,4,3;9,10,16,22,28,34,33,32,31,30,24,18,12,6,0,1,2;15,21,27,26,25,19,13,7;8,14,20
6,0,43,6;14,15,16,22,23;8,9,10,11,17;28,27,21,20;29,35,34,33,32,31,30,24,18,12;5,4,3,2,1;0,6,7,13,19,25,26
6,0,44,5;22,16,10,4,3,2;5,11,17,23,29,35,34,33,32,31,30,24,18,12,6;8,14,20,26,27,28;21,15,9;0,1,7,13,19,25
6,0,45,5;11,5,4,3,2,1,7,13,19,25;0,6,12,18,24,30,31,32,26,20,14,8,9,10,16;22,28,34,33;15,21,27;17,23,29,35
6,0,46,5;6,0,1,2,3,4,10,16,22,28,27,33;26,20,21,15,9,8,7;32,31,30,24,18,12;5,11,17,23,29,35,34;25,19,13,14
6,0,47,5;28,22,16,10,9,3;4,5,11,17,23,29,35,34,33,32,31;1,0,6,12,18;2,8,14,15,21,27,26,25,24,30;7,13,19,20
6,0,48,4;35,34,33,32,31,30,24,18,12;1,2,8,14,15;3,9,10,16,22,21,20,19,13,7,6,0;4,5,11,17,23,29,28,27,26,25
6,0,49,5;33,27,28,22,23,17,11,10,9,8,7,13,19,25;16,15,14;29,35,34;21,20,26;32,31,30,24,18,12,6,0,1,2,3,4,5
6,0,50,5;4,3,2,1,0,6,12,18,24,30,31,32,33,34,35;20,14,8,7;9,15,21,27,28,29,23,17;13,19,25,26;22,16,10,11,5
6,0,51,6;7,8,9,15,16;4,3,2,1,0,6,12,18,24,30,31,32,33,27;10,11,5;28,22,21,20,14,13;26,25,19;17,23,29,35,34
6,0,52,5;29,35,34,33,32,31;10,16,15,21,20,26,25,24,30;18,12,6,0;14,8,9,3,4,5,11,17,23,22,28,27;19,13,7,1,2
6,0,53,6;22,21,20,19,25;15,14,13,12,18,24,30,31;16,10,4,3,2,1,0,6;9,8,7;5,11,17,23,29,28,27;26,32,33,34,35
6,0,54,5;5,4,3,2,1,0;20,21,15,9,10,11;24,18,12,6,7,8;22,28,27,26,25,19,13,14;16,17,23,29,35,34,33,32,31,30
6,0,55,4;20,26,32,31,30;24,25,19,13,7,8,9,10,16,22,28;18,12,6,0,1,2,3,4,5,11,17,23,29,35,34,33,27;21,15,14
6,0,56,4;9,8,14,13,19,25,26,27,28,22;5,11,17,23,29,35,34,33,32,31,30,24,18,12,6,0;10,16,15,21,20;7,1,2,3,4
6,0,57,5;14,8,9,3,4,5;7,13,19,25;26,20,21,15,16,10,11;17,23,29,35,34,33,32,31,30,24,18,12,6,0,1,2;27,28,22
6,0,58,6;30,31,32,33,34,35,29,23,17,11,5;0,6,7,8,9;18,19,20,21,15;24,25,26,27,28,22,16,10,4;3,2,1;14,13,12
6,0,59,6;27,28,22,16,10,4,5;32,31,25;13,12,6,0,1,2,3,9,15,21,20,26;33,34,35,29,23,17,11;7,8,14;19,18,24,30
6,0,60,4;34,35,29,23,17,16,15;27,26,25,19,13,7;10,9,8,14,20,21,22,28;33,32,31,30,24,18,12,6,0,1,2,3,4,5,11
