5,0,1,5;21,16,17,18,19,14,9,8,7,6,5;10,15,20;13,12,11;22,23,24;0,1,2,3,4
5,0,2,4;7,6,5,10,15,20;4,9,14,19,24,23;0,1,2,3,8,13,18,17,22;21,16,11,12
5,0,3,4;24,23,22;16,11,6;3,8,13;4,9,14,19,18,17,12,7,2,1,0,5,10,15,20,21
5,0,4,3;0,5,10,15,20,21,22,23,24,19,14;9,4,3,2,7,12;1,6,11,16,17,18,13,8
5,0,5,5;4,3,2,1,0;5,6,7;9,8,13,12,11,10,15,20;16,21,22,23,24;17,18,19,14
5,0,6,4;18,17,16,15,10,5,0;1,2,3,4,9,14,19,24,23,22,21,20;7,8,13;6,11,12
5,0,7,5;7,2,1;10,15,16,17,18,13,8;12,11,6,5,0;23,22,21,20;3,4,9,14,19,24
5,0,8,4;8,9,14;23,22,21,20,15,10,5,0,1,2,3,4;17,16,11,6,7;12,13,18,19,24
5,0,9,4;22,21,20,15,10,5,0;24,19,14,9,4,3,2,7,12;8,13,18,23;17,16,11,6,1
5,0,10,5;14,19,24,23,22,21,20,15;4,9,8,13,18;16,11,10,5;17,12,7,2,3;6,1,0
5,0,11,4;0,1,2,3,4,9,14,19,24;12,17,16;23,22,21,20,15,10,5;11,6,7,8,13,18
5,0,12,5;23,18,13,8,3;12,17,22,21,20,15;24,19,14,9,4;7,2,1,0,5,10;6,11,16
5,0,13,4;0,5,10,15;24,23,18,13,8;19,14,9,4,3,2,7,12,17,22;1,6,11,16,21,20
5,0,14,4;14,9,4,3,2,7,12,17;1,0,5,10,15,20,21,22,23,24,19;6,11,16;18,13,8
5,0,15,5;6,7,8,9;19,14,13;4,3,2,1,0,5,10,15,20;24,23,18,17,12,11;16,21,22
5,0,16,5;16,15,10,5,0;2,7,12,17;20,21,22,23,24,19,14,9;4,3,8,13,18;1,6,11
5,0,17,5;6,11,12;16,17,22,23;13,8,7,2,1,0,5,10,15,20,21;24,19,18;14,9,4,3
5,0,18,4;24,19,18,17,16,11,6;23,22,21,20,15,10,5,0,1,2,7;8,3,4;12,13,14,9
5,0,19,3;5,10,15,20,21,22,23,24,19,14,13,8;0,1,6,11,16,17,18;9,4,3,2,7,12
5,0,20,5;3,8,13,18,23,22,21,16,11,6;20,15,10;7,12,17;5,0,1,2;4,9,14,19,24
5,0,21,5;12,13,18;1,6,11,16,17;4,3,2;0,5,10,15,20,21,22,23;24,19,14,9,8,7
5,0,22,5;21,22,23,24,19;13,14,9,4;0,5,10,11,12,7,8;18,17,16,15,20;3,2,1,6
5,0,23,3;23,18,13,8,7,6,11,16;12,17,22,21,20,15;24,19,14,9,4,3,2,1,0,5,10
5,0,24,4;9,4,3,2,1;10,15,20,21,22,23,24,19;8,7,12;0,5,6,11,16,17,18,13,14
5,0,25,4;8,7,6,11,16;2,3,4,9,14,13;19,18,17,12;1,0,5,10,15,20,21,22,23,24
5,0,26,4;12,11,6,1,2,3,4,9,14;16,17,18,19;0,5,10,15,20,21,22,23,24;7,8,13
5,0,27,4;6,11,16;22,17,18,13,8,3,4;12,7,2,1,0,5,10,15,20,21;23,24,19,14,9
5,0,28,4;8,13,18,23,22,21,16,11,6;17,12,7;20,15,10,5,0,1,2;3,4,9,14,19,24
5,0,29,4;7,12,11,10,15;20,21,22,23,24,19,14,9,4,3,2,1;8,13,18,17,16;0,5,6
5,0,30,4;0,5,10,15,20;7,12,17,18,23;24,19,14,9,4;13,8,3,2,1,6,11,16,21,22
6,0,1,6;33,34,35,29,23,17,11,5,4;21,20,26,32,31,30,24,18,12,6;13,19,25;7,8,14,15;27,28,22,16,10;0,1,2,3,9
6,0,2,5;24,25,26,20,14,15,16,22;11,10,9,8,7,13,19,18;30,31,32,33,34,35,29,23,17;28,27,21;5,4,3,2,1,0,6,12
6,0,3,5;35,29,23;26,27,28,34;8,7,13,19,25,31,32,33;20,21,22,16,17,11,5,4,3,2,1,0,6,12,18,24,30;10,9,15,14
6,0,4,5;34,33,32,31,30,24,18,19,20,14,15,16,17,11,5,4,3;25,26,27,28;13,12,6,0,1,2;10,9,8,7;21,22,23,29,35
6,0,5,5;4,3,2,1,0,6;31,32,33,34,28,22,21,20,19;5,11,10,9,8,7;27,26,25,24,30;18,12,13,14,15,16,17,23,29,35
6,0,6,4;20,21,27,33;34,28,22,16,15,14,13,19,25,26;35,29,23,17,11,10,9,8,7;5,4,3,2,1,0,6,12,18,24,30,31,32
6,0,7,5;21,20,14,8,9;10,16,15;19,13,7;22,28,27,26,25,24,30;18,12,6,0,1,2,3,4,5,11,17,23,29,35,34,33,32,31
6,0,8,4;0,1,2,3,4,5,11,17,23,29,35,34,33,32,31,30,24,18;14,20,21;12,6,7,8,9,15;10,16,22,28,27,26,25,19,13
6,0,9,4;35,29,23,22,16,15,14;34,33,32,26,25,19,13,7,8,9,10;17,11,5,4,3,2,1,0,6,12,18,24,30,31;20,21,27,28
6,0,10,5;5,11,17,23,22,28,27,26,25;19,13,7;29,35,34,33,32,31,30,24,18,12,6,0,1;9,8,14,20;2,3,4,10,16,15,21
6,0,11,6;14,20,26,32,31,30,24;23,29,28;35,34,33,27,21,15;17,11,5,4,3,2,1,0,6;12,13,7,8,9,10,16,22;25,19,18
6,0,12,6;15,9,8,7,1,0;10,16,22,23;28,27,21,20,14,13;26,25,19,18,12,6;2,3,4,5,11,17;29,35,34,33,32,31,30,24
6,0,13,5;34,35,29,23,17,11,5,4,3,2,1;0,6,7,8,9,10,16,22,28;24,25,26;20,19,18,12;30,31,32,33,27,21,15,14,13
6,0,14,6;0,1,7,13,19;25,26,20,14,8,2,3,4,5;9,10,11,17;28,27,21;24,30,31,32,33,34,35,29,23,22,16,15;6,12,18
6,0,15,5;32,33,34,35,29;21,20,19,13,7;5,4,10,16,15,14,8;25,26,27,28,22,23,17,11;9,3,2,1,0,6,12,18,24,30,31
6,0,16,6;1,7,13,14,15,21;30,24,25,26,27;17,11,5,4,3,2;31,32,33,34,28;0,6,12,18,19,20;35,29,23,22,16,10,9,8
6,0,17,6;10,11,5;1,2,3,4;17,23,29,35,34,33,32,31,30,24,18,12,6,0;22,21,20,14,8,7;28,27,26,25,19,13;9,15,16
6,0,18,4;21,20,26,32;28,22,16,10,9,8,7,6,12,18,24,30,31;27,33,34,35,29,23,17,11,5,4,3,2,1,0;25,19,13,14,15
6,0,19,4;15,14,20,19,18,24,30,31,32,33;6,0,1,2,3,4,5,11,17,23,29;35,34,28,22,16,10,9,8,7,13,12;21,27,26,25
6,0,20,5;25,26,27,28,22;7,13,19;11,5,4,3,2,1,0,6,12,18,24,30,31,32,33,34,35,29,23;17,16,15,21,20;10,9,8,14
6,0,21,5;6,0,1,2,3,4,5;14,20,19;28,22,23,17,11,10,9,8,7,13,12,18,24,30,31;32,33,34,35,29;25,26,27,21,15,16
6,0,22,4;11,5,4,3,2,1,0,6,12,18,24,30,31,32;14,20,26,27,33,34,35;28,22,21,15;29,23,17,16,10,9,8,7,13,19,25
6,0,23,4;5,11,10,9,8,7,13,19,20,21,22;4,3,2,1,0,6,12,18,24,30,31,32,33;25,26,27,28,34;35,29,23,17,16,15,14
6,0,24,5;21,15,9;25,19,13,7;4,3,2,1,0,6,12,18,24,30,31,32,33,34,35,29,23,17;26,20,14,8;5,11,10,16,22,28,27
6,0,25,5;12,6,0,1,2,3,4;35,29,23,17,16,15,21,27;32,31,30,24,18,19,13,7;33,34,28,22;5,11,10,9,8,14,20,26,25
6,0,26,5;5,11,17,23,29;22,16,10,4;21,15,9,3,2,1,0;20,14,8,7,6,12,18,24,30,31,32,33;13,19,25,26,27,28,34,35
6,0,27,5;18,19,13,7;28,22,16,10,9;15,21,27;25,26,20,14,8;24,30,31,32,33,34,35,29,23,17,11,5,4,3,2,1,0,6,12
6,0,28,6;9,8,14;1,7,13;19,20,21,15,16,10;0,6,12,18,24,30,31,32,33,34,35,29,23,17,11,5;25,26,27,28,22;2,3,4
6,0,29,5;24,18,12,6,0,1,2,3,4,5;7,13,19,20;14,15,21;8,9,10,16,22,28,27,26,25;11,17,23,29,35,34,33,32,31,30
6,0,30,5;15,21,27;0,6,7,8,9,10,16,22,28;31,25,19;23,29,35,34,33,32,26,20,14,13,12,18,24,30;1,2,3,4,5,11,17
7,0,1,6;10,17,24,31,30,29,28,35,42,43,44,45,46,47,48,41,34,27,20,13,6;36,37,38,39,40,33,26,19,12,5,4,3,2,1,0;7,8,9;32,25,18,11;14,15,16;23,22,21
7,0,2,7;13,6,5,4,3,2,1,0,7;26,25,24;47,46,45,38,31,30,23,16,17;12,11,10,9,8,15,22,29,36,37,44;14,21,28,35,42,43;32,33,34,27,20,19,18;48,41,40,39
7,0,3,5;0,1,2,3,10,17,24,25;41,34,27,20,13,12;48,47,46,45,44,43,42,35,28,21,14,7,8;23,30,31,32;9,16,15,22,29,36,37,38,39,40,33,26,19,18,11,4,5,6
7,0,4,5;13,12,19,18,25,32,33,34,41,48,47,46,45,44,37,30,23;35,28,21,14,7,0,1,2,3,4,5,6;16,17,24,31,38,39,40;42,43,36,29,22,15,8,9,10,11;20,27,26
7,0,5,6;40,39,38,31,30,23,16;4,11,18,25,32,33;12,19,26;3,2,1,0,7,14,21,28,35,42,43;5,6,13,20,27;34,41,48,47,46,45,44,37,36,29,22,15,8,9,10,17,24
7,0,6,5;8,9,10,11;18,17,16,15,22,29,36,37,38,39,40;6,13,20,27,34,41,48,47,46,45,44,43,42,35,28,21,14,7,0,1;2,3,4,5,12,19,26,25,24,23;30,31,32,33
7,0,7,6;12,19,26,33,40,47,46,45,38,31,30,23,22,21,28,35,42,43;29,36,37,44;24,17,16;20,27,34,41,48;39,32,25,18,11,10,9,8;15,14,7,0,1,2,3,4,5,6,13
7,0,8,6;24,23,22,21,28,35,42,43,44,45,46,47,40,33,26,19,12,11,4,3,2;48,41,34,27,20,13,6,5;29,30,31,32,25,18;17,10,9,8,1;36,37,38,39;0,7,14,15,16
7,0,9,8;42,43,44,45,46,47,48,41,34,27,26,19,18;6,5,4,3,10,17,24,31,38,39;1,2,9,16,15,14,21,28;0,7,8;22,23,30,37;25,32,33,40;20,13,12,11;29,36,35
7,0,10,5;15,8,9,10,11,12,19,26,25,24,23;18,17,16;22,29,30,31,32,33,34,41,48,47,46,45,44,43,42;2,1,0,7,14,21,28,35,36,37,38,39,40;3,4,5,6,13,20,27
7,0,11,5;37,38,31,24,23;15,8,9,10,11,12,19,26,33,40,47;22,21,28,35,42;14,7,0,1,2,3,4,5,6,13,20,27,34,41,48;30,29,36,43,44,45,46,39,32,25,18,17,16
7,0,12,5;9,2,3,4,5,6,13,20,27,34,41,48,47,46,45,44,43,42,35,28,29;10,11,12,19,26,33,40,39,38,37,36;18,17,24;25,32,31,30,23,16,15,8,1;22,21,14,7,0
7,0,13,6;20,27,34,41,48,47,46,45,44,43,42,35,28,21,14,7,0,1;36,29,30,31,32,33,26;3,2,9,8,15,22,23,24,25,18;19,12,11,10,17,16;13,6,5,4;40,39,38,37
7,0,14,6;15,8,9,10,11,12,13,20,27,34,41,48,47,46,45,44,37,36;16,17,24,31,30,29,28,35,42,43;26,33,40,39,38;2,1,0,7,14,21,22,23;19,18,25,32;3,4,5,6
7,0,15,6;19,12,11,10,17,16;18,25,24,23,30,29,28,21,14,7,0,1;34,41,48;43,44,45,46,39,32,31;22,15,8,9,2,3,4,5,6,13,20,27,26,33,40,47;38,37,36,35,42
7,0,16,5;25,24,23,30,37;6,5,4,3,2,1,0,7;42,35,28,21,14,15,16,17,18,19,26,33,40;32,31,38,45,44,43,36,29,22;8,9,10,11,12,13,20,27,34,41,48,47,46,39
7,0,17,7;4,5,6;3,10,11,12,13,20,27,34;46,47,48,41;38,31,24,17,18,19,26,33;45,44,43,42,35,28,21,14,7,0,1,2,9,16,23,30;8,15,22,29,36,37;40,39,32,25
7,0,18,4;26,27,34,41,48;6,13,12,11,10,9,8,15,22,29,36,37,38,39;5,4,3,2,1,0,7,14,21,28,35,42,43,44,45,46,47,40,33,32,31,30,23,16,17;24,25,18,19,20
7,0,19,7;0,7,14,21,28,29,36;2,3,4,5,6,13,20,27,34,41,40,39,32,25,18;35,42,43,44,37,38,31,24;30,23,22,15;16,17,10,11,12,19,26,33;9,8,1;45,46,47,48
7,0,20,5;41,40,33,32;6,13,20,27,34;5,12,19,26,25,24,31;39,38,37,36,29,22,15,8,9,10;48,47,46,45,44,43,42,35,28,21,14,7,0,1,2,3,4,11,18,17,16,23,30
7,0,21,6;36,29,30,31,32;16,17,18;9,8,15,22,23,24,25,26,19;12,11,10,3,2,1,0,7,14,21,28,35,42,43,44,45,46,47,48,41,34,33;37,38,39,40;27,20,13,6,5,4
7,0,22,5;48,47,46,45;44,43,42,35,28,21,14,7,0,1,2,3,4,5,6,13,20,27,26,25,24;40,39,38,37,30,23,16,17,18,19;36,29,22,15,8,9,10,11,12;41,34,33,32,31
7,0,23,6;38,37,36,29,28,21;8,9,16,17,24,25;12,5,4,3,2,1,0,7,14,15,22,23,30;31,32,33,26,19,18,11,10;39,40,41,34,27,20,13,6;48,47,46,45,44,43,42,35
7,0,24,6;0,7,14,21,22,29,36;39,38,37,30,23,16,9,10,11,12;25,18,19,20,13,6,5,4,3,2,1,8,15;47,40,33,32,31,24,17;28,35,42,43,44,45,46;48,41,34,27,26
7,0,25,6;1,2,3,4,5,6,13,20,27,34,41,48,47;46,39,40,33;8,7,0;35,42,43,44,45,38,31,32,25,26,19,12,11,10,9,16,15,14,21;18,17,24,23,22,29,28;36,37,30
7,0,26,6;38,37,36,35,42;16,17,18,19;43,44,45;12,11,10;47,40,33,26,25,24,23,22,15,8,9;48,41,34,27,20,13,6,5,4,3,2,1,0,7,14,21,28,29,30,31,32,39,46
7,0,27,5;35,36,37,38,39,40,33,26,19,18,17,16,15,8,1;32,25,24,23,22;2,3,4,5,6;0,7,14,21,28,29,30,31;42,43,44,45,46,47,48,41,34,27,20,13,12,11,10,9
7,0,28,5;23,22,29,36,37,38,39,40,33,26,19,12;18,11,4,3;30,31,32;8,15,16;25,24,17,10,9,2,1,0,7,14,21,28,35,42,43,44,45,46,47,48,41,34,27,20,13,6,5
7,0,29,6;36,37,38,39,40,33;26,25,32,31,30,29,28,21,14,7,0,1,2,3,4,5,6;13,20,27,34,41,48,47,46,45,44,43,42,35;24,23,22;8,9,10,11,12;19,18,17,16,15
7,0,30,7;19,26,33,40,39;6,5,4;41,34,27,20,13,12,11,18;37,36,35,28,21,14,7,0,1,2,9,16,23;3,10,17,24,25,32;48,47,46,45,44,43,42;38,31,30,29,22,15,8
8,0,1,7;15,14,13,12,20,19,27,35;7,6,5,4,3,2,1,0,8,16,24,32,40,48,56,57,58,59,60;61,62,63,55;31,30,38,37,45,44,43,42,34,26;11,10,9;39,47,46,54,53,52,51,50,49,41,33,25,17,18;36,28,29,21,22,23
8,0,2,6;60,61,62,63,55,47,39,31;5,6,7,15,23,22,30,38,46,54,53,52,44,36,28,20,19,18,26,34,42,41;49,50,51,43,35,27;21,29,37,45;14,13,12,11,10,9,17,25,33;59,58,57,56,48,40,32,24,16,8,0,1,2,3,4
8,0,3,8;60,52,44,45,37,29,21,22,14,15,7;0,8,16,24,32;57,56,48,40,41,33,25,17,9,1,2,3,4;23,31,30,38,46,54,53;6,5,13,12,20,28,36;61,62,63,55,47,39;10,11,19,27,35,43,51,59,58;49,50,42,34,26,18
8,0,4,7;52,51,43,42;9,10,2,3,4,5,6,7,15,23,31,39,47,55,54,53;36,35,34,33,41,49,50;37,29,21;1,0,8,16,17;20,28,27,26,25,24,32,40,48,56,57,58,59,60,61,62,63;18,19,11,12,13,14,22,30,38,46,45,44
8,0,5,7;7,6,14,13,21,20,28,27;3,2,1,0,8,16,24,32,33,41,42,43,44,45;9,10,11,12,4,5;25,26,34,35,36,37,29;56,57,58,59,60,61,62,63,55,47,39,31;40,48,49,50,51,52,53,54,46,38,30,22,23,15;19,18,17
8,0,6,7;57,56,48,40,32,33;52,60,59,58,50;51,43,35,36;17,18,19,20,21,29,37,38,46,54;25,24,16,8,0,1,2,3,4,5,6,7,15,23;44,45,53,61,62,63,55,47,39,31,30,22,14,13,12,11,10,9;49,41,42,34,26,27,28
8,0,7,8;8,0,1,2,10,18,26,25,33,41,49;30,29,28,36;12,13,14,15;37,45,44,43,51,59,60,61,62,63,55,47,39;7,6,5,4,3,11,19,20,21,22,23,31;50,42,34,35,27;58,57,56,48,40,32,24,16,17,9;38,46,54,53,52
8,0,8,7;45,37,36,35,34,26,18,19;46,54,53,52,51,50,49;21,29,30,31,23,15,7,6;44,43,42,41,33,25,17,9;11,12,20,28,27;3,4,5,13,14,22;10,2,1,0,8,16,24,32,40,48,56,57,58,59,60,61,62,63,55,47,39,38
8,0,9,7;11,10,18,26;0,8,16,24,32,40,48,56,57,58,59,60,61,62,63,55;27,19,20,21,22,23,15,7,6,5,4,3,2,1,9,17,25,33,34;41,49,50,51,52,44,45;42,43,35,36,37,38,46,54,53;28,29,30,31,39,47;14,13,12
8,0,10,7;10,11,12,13,21,29,37;9,17,18,26,27;56,48,40,32;19,20,28,36;34,42,50,51,52,53,54,55,47,39,31,23;7,6,5,4,3,2,1,0,8,16,24,25,33,41,49,57,58,59,60,61,62,63;15,14,22,30,38,46,45,44,43,35
8,0,11,8;63,62,61,53,45,44,43;42,34,26,18,19,20;27,35,36,37,38,46,54,55;28,29,30,22,14;21,13,5,6,7,15,23,31,39,47;3,2,1,0,8,16,24,32,40,41,49,50,51,52;33,25,17,9,10,11,12,4;48,56,57,58,59,60
8,0,12,7;59,51,43;58,57,56,48,40,32,24,16,17,18,19,11,3,4,5,6,7,15,23,31,39;54,53,45,37,29,21;10,2,1;13,12,20,28,27,26,25,33,41,49,50;14,22,30,38,46,47,55,63,62,61,60,52,44,36,35,34,42;9,8,0
8,0,13,6;7,15,23,31,39,47,55,63,62;27,26,34,33,41;49,50,42,43,35,36,28,20,19,18,10,2,3,4,5,6,14,22,30,38,46,54,53,61,60;1,9,17,25;0,8,16,24,32,40,48,56;57,58,59,51,52,44,45,37,29,21,13,12,11
8,0,14,6;53,54,46,38,37,36,35;45,44,52,60;30,29,28,27,26,34,42,43,51,59,58,57,56,48,40,32,24,16,8,0,1,2,3,4,5,6,7,15;50,49,41,33,25,17,9,10,11,12,13;61,62,63,55,47,39,31,23,22,14;21,20,19,18
8,0,15,7;49,50,51,52,53,54;27,26,25,17,9;11,3,2,1,0,8,16,24,32,33,34,35,36,28,29,21;20,19,18,10;12,13,14,22,30,38,46,47,55,63,62,61,60,59;39,31,23,15,7,6,5,4;58,57,56,48,40,41,42,43,44,45,37
8,0,16,7;59,51,52,53,54,46,38,30,22;29,37,45,44,43,42,50,58,57,56;49,41,33,34,35,36,28,20,21,13,14,15;23,31,39,47,55,63,62,61,60;7,6,5,4,12,11,10,18,17,16,8,0;19,27,26,25,24,32,40,48;3,2,1,9
8,0,17,7;49,41,33,34,35,36,28;38,30,22,14,13,12,11;9,10,18,19,20,21,29,37;52,53,54,46,47,39,31,23,15,7,6,5,4;51,59,60,61,62,63,55;3,2,1,0,8,16,17,25,26,27;24,32,40,48,56,57,58,50,42,43,44,45
8,0,18,7;37,29,28,27;42,43,51,52,53,54,55,47,39,31,23,15;1,2,3,4,12;57,56,48,40,32,24,16,17,18,26,34,35,36,44,45,46,38,30,22,14;63,62,61,60,59,58,50,49,41,33,25;7,6,5,13,21,20,19;11,10,9,8,0
8,0,19,8;9,10,11,12,13,21,22,30,38,46,54,53,52;36,35,27,26;24,16,8,0,1,2;49,41,42,34;14,15,23,31,39,47,55,63,62,61,60,59;57,58,50,51,43;3,4,5,6,7;44,45,37,29,28,20,19,18,17,25,33,32,40,48,56
8,0,20,6;21,20,28,36,35,34;0,1,2,3,4,5,6,7,15,23,31,39,47,55,63,62,61,60,59,51,43,44,45,37,29;56,57,58;52,53,54,46,38,30,22,14,13,12,11,10,9,8;18,17,16,24,32,40,48,49,50;42,41,33,25,26,27,19
8,0,21,6;48,49,50,51,52,53,54,46,38,30,22,14,13,12,11,10,2;56,57,58,59,60,61,62,63,55,47,39,31,23,15,7,6,5,4,3;44,36,35,34,33,25;21,20,19,18,17,9,1;45,37,29,28,27,26;0,8,16,24,32,40,41,42,43
8,0,22,6;0,8,9,17,25,33,41,49;19,27,35,43,51,52,53,45,37,29,21,13,5,6,7,15,23,31;1,2,3,4,12,20,28,36,44;39,47,55,63,62,61,60,59,58,57,56,48,40,32,24,16;14,22,30,38,46,54;11,10,18,26,34,42,50
8,0,23,6;50,49,41,33,34,35,36,44,45;59,51,43,42;60,52,53,54,46,38,37,29,28,27,26;25,17,9,10,11,12,13,14;61,62,63,55,47,39,31,23,15,7,6,5,4,3,2,1,0,8,16,24,32,40,48,56,57,58;30,22,21,20,19,18
8,0,24,7;34,26,18,19;45,53,61,62,63,55,47,39,31,23,15,7,6,5,4,3,2,1,0,8,16,24,25,33;41,42,43,35,27,28,20,12,11,10,9,17;32,40,48,56,57,58,59,60;52,51,50,49;54,46,38,30,22,14;44,36,37,29,21,13
8,0,25,9;30,29,21,20,12,11,10,9,17,25,33,41,49,57,56;5,6,7,15;23,22,14,13;37,38,46,54,53,52,51;26,34,42,43;50,58,59,60,61,62,63,55,47,39,31;28,36,44,45;35,27,19,18;4,3,2,1,0,8,16,24,32,40,48
8,0,26,7;14,22,21;2,1,0,8,16,24,32,40,48,56,57,58,59,51,52,44,45,37,29,28;4,3,11,10,9;60,61,53,54,46,38,30;36,35,27;26,34,42,43;62,63,55,47,39,31,23,15,7,6,5,13,12,20,19,18,17,25,33,41,49,50
8,0,27,8;50,42,34,26;24,25,33,41,49;53,45,44,36;39,31,23,15,7,6,5,4,3,2,1;32,40,48,56,57,58,59,60,61,62,54;0,8,16,17,18,19,20,21,29,37,38,46,47,55,63;30,22,14,13,12,11,10,9;52,51,43,35,27,28
8,0,28,7;21,13,5;6,14,22,30,29,28,20,19,18,10,2,3;54,53,52,51,50,49,41,40;48,56,57,58,59,60,61,62,63,55,47,46,45,44,43,42,34,33;32,24,16,8,0;11,12,4;7,15,23,31,39,38,37,36,35,27,26,25,17,9,1
8,0,29,9;23,15,7,6,5,4;49,41,33,25,26;52,60,61,62;59,58,50,42,34,35,27,28,29,37,45,53,54;21,20,19,18,17;51,43,44,36;10,9,8,16,24,32,40,48,56,57;63,55,47,46,38;39,31,30,22,14,13,12,11,3,2,1,0
8,0,30,7;29,21,13;41,49,48;27,35,43,44,45,46,38,30,22,14,6,5,4,3,2,1,0,8,16,24;7,15,23,31,39,47,55,54,53,52,51,50,42,34,26;37,36,28,20,19,18,17,25,33,32,40;56,57,58,59,60,61,62,63;12,11,10,9
9,0,1,8;42,51,60;67,58,49,48,39,30,21,20,19,28,37,46,55,64;34,35,26,17,8,7,6,5,4,3,2,1,0,9,18,27,36,45,54,63,72,73,74,65;53,62,71,80,79,78,77,76,75,66,57,56,47,38,29;25,16,15,14,13,12,11,10;24,33,32;23,22,31,40,41,50,59,68;69,70,61,52,43,44
9,0,2,9;30,39,40,49,50,51,60,61;25,16,15;72,63,54,45,36,27,18,9,0,1,2,3,4,5,6,7,8,17;70,69,68,59,58,57,48,47,38,29,20;14,23,24,33,34,43,52;26,35,44,53;21,22,31,32,41,42;56,65,66,67,76,77,78,79,80,71,62;13,12,11,10,19,28,37,46,55,64,73,74,75
9,0,3,9;39,38,47,46;25,26,17,8,7,6,5,4,3,2,1,0,9,18,27;63,64,55,56,57,48;29,30,31,32,41,50,59,68,77,76,75,74,73,72;54,45,36,37,28;10,11,12,13,14,15,16;70,61,52,43,34,35;44,53,62,71,80,79,78,69,60,51,42,33,24,23,22,21,20,19;65,66,67,58,49,40
9,0,4,8;59,60,69,78,79,80,71,62,53,44,43,42,33,24,23,22,21,20,29,38,47,56,55;39,40,49,58,67,68;30,31,32,41,50,51,52,61,70;73,74,75,76,77;54,45,36,27,18,9,0,1,2,3,4,13,14,15,16,25,34;12,11,10,19,28,37,46;35,26,17,8,7,6,5;72,63,64,65,66,57,48
9,0,5,9;5,6,7,8,17,26,35,44,53,62,71,80,79,78,77,68,67;38,29,20,21,12,13,14,15,16,25,34;22,23,32,41,50,51;31,40,49;69,60,59,58,57,66,65,64,55,46,37,28,19,10,11;56,47,48,39,30;76,75,74;73,72,63,54,45,36,27,18,9,0,1,2,3,4;24,33,42,43,52,61,70
9,0,6,8;32,41,50,49,48;39,30,21,20,11,2,3,4,5,14,23;17,8,7,6,15,24,33,34,43,52,61,70,69,68,67,66,65,64,55;16,25,26,35,44,53,62,71,80,79,78,77,76,75,74,73,72,63,54,45,36;42,51,60,59,58,57,56,47,46,37;27,18,9,0,1;12,13,22,31,40;38,29,28,19,10
9,0,7,8;12,11,10,19,28,37,46,55,64;74,73,72,63,54,45,36,27,18,9,0,1,2,3,4,5,6,15,16,25;71,70,69,60,59,50,49,40,39,30,21;13,14,23,24,33,34,43,52,61,62;51,42,41,32,31,22;80,79,78,77,76,75,66,65,56,47,38,29,20;53,44,35,26,17,8,7;48,57,58,67,68
9,0,8,8;60,59,58,49,48,47;16,25,34,43;10,11,12,13,22,31,32,33,42;36,27,28,29,38;37,46,45,54,63,72;80,71,62,53,44,35,26,17,8,7,6,15;65,74,75,76,77,78,79,70,61,52,51,50,41,40,39,30,21,20,19,18,9,0,1,2,3,4,5,14,23,24;69,68,67,66,57,56,55,64,73
9,0,9,8;66,75,74,73,72,63,54,45,36,27,18,9,0,1,2,3,4,5,6,7,8,17,26,35,44,53,62,71;24,33,42,41,40,49;80,79,78,77,76,67;70,69,68,59,58,57;64,55,46,37,38,29,20,21,22;65,56,47,48,39,30,31,32,23;61,60,51,50;52,43,34,25,16,15,14,13,12,11,10,19,28
9,0,10,7;32,41,40,39,38,37,36,45,54;31,30,29,28,27,18,9,0,1,2,11,12,13,14,15,16,25,34,43,52,61,70,69;55,46,47,48;76,77,68,59,60,51,42,33,24,23,22,21,20,19,10;64,65,56,57,58,49,50;3,4,5,6,7,8,17,26,35,44,53,62,71,80,79,78;63,72,73,74,75,66,67
9,0,11,10;22,31,32,33;23,24,25,34,43;52,51,50,59,68;16,15,14,13,12,21,30,39,40,41,42;71,62,61,60,69,78,77,76,75,74,73,72,63,54,55,56;49,58,67,66,65,64;37,38,29,20,11,2,3,4,5,6,7,8,17,26,35,44,53;70,79,80;10,19,28;57,48,47,46,45,36,27,18,9,0,1
9,0,12,8;14,15,16,25,34,43,52,53,62,71,80,79,78,77,76,75,74,73,72,63,54,45,36,27,18,9,0,1,2,3,12,21,20,29;23,32,41,40;70,69,68,67,66;61,60,59,58;65,56,57,48,49,50,51,42,33,24;37,28,19,10,11;4,5,6,7,8,17,26,35,44;64,55,46,47,38,39,30,31,22,13
9,0,13,8;72,73,74,75,76,77,78,69,60,59;8,17,26,35,44,53,62,71,80;0,1,2,3;9,10,11,12,13,4,5,6,7,16,25,34,43,42,41,40;79,70,61,52,51,50,49,48,47;28,29,20,21,22,23,14;15,24,33,32,31,30,39,38,37,46,55,56,57,58,67,68;19,18,27,36,45,54,63,64,65,66
9,0,14,10;72,63,54,55,56,57,58;23,24,33,42,41,40,39,48,47,46,45;80,71,62,53,44,35,26,17,8,7,6,5,4,3;1,10,19,20,21,22;38,37,36,27,18,9,0;2,11,12,13,14,15,16,25,34,43;49,50,59,68,67,66,65,64,73;52,61,70,79,78,77,76,75,74;32,31,30,29,28;51,60,69
9,0,15,9;78,77,76,75,74,65,56,47,38,29,20,19,18,27,36,45,54,63,72;34,43,52,61,60;73,64,55,46,37,28;8,7,6,5,4,3,2,1,0,9;31,22,13;71,62,53,44,35,26,17,16,15,14,23,32,41,40,49,48,57,66,67;80,79,70,69,68,59,58;10,11,12,21,30,39;25,24,33,42,51,50
9,0,16,8;17,26,35,34,33,42;52,61,70,79,78,77,76,75,74,73,72,63,54,45,36,27,18,9,0,1,2,3,4,5,6,7,8;58,59,50,41,32,23,24,25;51,60,69,68,67,66,65,64,55,46,37,28,19,10;43,44,53,62,71,80;22,31,40,49;21,30,39,48,57,56;16,15,14,13,12,11,20,29,38,47
9,0,17,9;1,10,19,28,37;57,48,39,30,31,22,23,24,33,42,51,52;13,14,15,16,25,34,43;21,12,3,4,5,6,7,8,17,26,35,44,53,62,61,60,59,50,41,32;0,9,18,27,36,45,54,55,56;72,73,74,75,76,77,78,79,80,71;46,47,38,29,20,11,2;70,69,68,67,66,65,64,63;58,49,40
9,0,18,7;20,21,22,23,32,41,50,59,68,77,76;18,9,0,1,2,3,4,5,6,7,8,17,26,35,44,53,62,71,80,79,78,69,60,51,42,33,24;37,38,29,30;67,66,75,74,73,72,63,54,45,46,47,48,39,40,31;55,64,65;70,61,52,43,34,25,16,15,14,13,12,11,10,19,28,27,36;56,57,58,49
9,0,19,9;56,57,58,59,60,51,52,53,44,35,26,17,8,7;37,38,39,40,41;21,20,11,10,1,0;9,18,27,36,45,54,63,72,73,74,75,76,77,78,79,80,71,62;22,13,12;42,33,24,23,14,5,4,3,2;61,70,69,68,67,66,65,64,55,46,47,48,49,50;43,34,25,16,15,6;32,31,30,29,28,19
9,0,20,9;60,61,62,71,80,79,78,77,76,75,74,65,64;30,21,22,23,24,25,34,43,42;45,36,27,18,9,0,1,2,3,12,13;33,32,31,40,39,38,29,20,11,10;4,5,14,15,16;70,69,68,59,50,41;66,67,58,49,48,47,46,37,28,19;73,72,63,54,55,56,57;51,52,53,44,35,26,17,8,7,6
9,0,21,8;76,77,68,69,70,61,52,51,42,33,24,23,22,21,20,29;37,38,39,30,31,32,41,50,59,60;15,14,13,12,11,10,19,28;6,5,4,3,2,1,0,9,18,27,36,45,54,63,72,73,74,75;40,49,48,47,46,55,64,65,66;7,16,25,34,43;8,17,26,35,44,53,62,71,80,79,78;67,58,57,56
9,0,22,8;30,39,38,47,56;0,9,18,27,36,37,46,55,64,65;61,70,69,68;25,34,43,42,41,50,59,58,67,76,77,78,79,80,71,62;11,20,21,22,23,24,33;45,54,63,72,73,74,75,66,57,48,49,40,31,32;60,51,52,53,44,35,26,17,8,7,6,5,4;29,28,19,10,1,2,3,12,13,14,15,16
9,0,23,8;63,72,73,74,75,76,67,68,69,70,71;24,23,22,13,12,11,20,29,38,39,40,41,42;14,15,16,25,26,35,44,53;51,50,49,48,47,56;21,30,31,32,33,34,43,52,61,62;10,19,28,37,46;80,79,78,77;60,59,58,57,66,65,64,55,54,45,36,27,18,9,0,1,2,3,4,5,6,7,8,17
9,0,24,7;0,1,10,19,28,29,38,39,40,31,22,23,24,33,42,51,60,59,58;57,56,47,46,45,54,63,72,73,74,75,76,77,78,79,80,71,62,53,44,35,26,17,8,7,6,5,4,3,2;48,49,50,41,32;55,64,65,66,67;11,12,13,14,15,16,25,34,43,52,61,70,69,68;37,36,27,18,9;20,21,30
9,0,25,7;49,50,59;56,65,74,75,76,77,78,79,80,71,62,53,44,35,26,17,8,7,6,5,4,3,2,1,0,9,18,27;25,16,15,14,13,12,11,10,19,28,37,36,45,54,63,72;55,64,73;40,39,48,57,66;60,51,42,41,32,31,30,29,38,47,46;58,67,68,69,70,61,52,43,34,33,24,23,22,21,20
9,0,26,7;61,62,71,80,79,78,77,76,75,74,73,72,63,54,45,36,27,18,9,0,1,2,11,12,13,14,15,16,25;3,4,5,6,7,8,17,26;49,40,39,38,47,56,65,66,67,68,69,70;52,43,42,33,24,23,22,21,20,19,10;34,35,44,53;64,55,46,37,28,29,30,31,32,41,50,51,60;48,57,58,59
9,0,27,8;44,35,26,17,8,7,6,5,4,3,2,1,10,19,28,37,46,47,56,57,58,67,68,69;48,39,38,29,20,11,12,13,14;32,41,42,51,52,53,62,71,80,79,78;55,64,65,66,75,76,77;43,34,33,24,23,22;70,61,60,59,50,49,40,31,30,21;15,16,25;74,73,72,63,54,45,36,27,18,9,0
9,0,28,7;20,29,38,47,56,65,66,67,68,69,70,61,52,43;16,15,14;25,26,17,8,7,6,5,4,13,22,23;11,10,19,28,37,46,55,64;60,51,42,33,24;49,40,31;32,41,50,59,58,57,48,39,30,21,12,3,2,1,0,9,18,27,36,45,54,63,72,73,74,75,76,77,78,79,80,71,62,53,44,35,34
9,0,29,9;63,54,45;0,1,2,3,12,13,14,15,16;72,73,64,55;65,56,47,48,49,58,67,76,77,78,79,80,71,62,53;74,75,66,57;43,34,25,24,23,22,21,20,11,10,9,18,27,36,37,46;19,28,29,30,31,32,33,42,51,60;44,35,26,17,8,7,6,5,4;52,61,70,69,68,59,50,41,40,39,38
9,0,30,9;80,79,78,69,60,51;56,47,38,37,28,19,20,21,22,31,32,33,34,35,44,53,62;0,1,2,3,4,5,6,15,16;57,48,39,30,29;71,70,61,52,43,42;66,67,58,49,40,41;50,59,68,77,76;7,8,17,26,25,24,23,14,13,12,11,10,9,18,27,36,45,54,63,72,73;75,74,65,64,55,46
