5,0,1,4;24,23,18;15,20,21,22,17,12,13,14,19;8,7,6;9,4,3,2,1,0,5,10,11,16
5,0,2,4;11,6,7,8;24,19,14,9,4,3,2,1,0,5;16,17,12;10,15,20,21,22,23,18,13
5,0,3,4;8,13,18,17,16,15,20;7,2,3,4,9,14,19,24,23,22,21;12,11,6,1;10,5,0
5,0,4,4;5,0,1,2;4,3,8,13,18,17,16,11,10;6,7,12;9,14,19,24,23,22,21,20,15
5,0,5,4;16,17,12;15,20,21,22,23,18,13,8,7,6;24,19,14,9,4,3,2;1,0,5,10,11
5,0,6,4;5,0,1,2,3,4,9;8,13,18,17,16;12,7,6;14,19,24,23,22,21,20,15,10,11
5,0,7,4;21,16,11,6,5,0;18,13,8,3,2,1;4,9,14,19,24,23,22,17,12,7;10,15,20
5,0,8,4;1,0,5,10;16,17,18;8,13,12,11;15,20,21,22,23,24,19,14,9,4,3,2,7,6
5,0,9,5;0,1,2;11,12,13,18;4,9,14,19,24,23,22;20,21,16,17;15,10,5,6,7,8,3
5,0,10,4;12,11,10,5,0,1,2,3,4,9,14,19,24,23;15,20,21,22;18,17,16;13,8,7,6
5,0,11,4;16,17,18,13,14;0,5,10,15,20,21,22,23,24,19;4,3,2,1,6,11,12;7,8,9
5,0,12,4;8,13,18,17,16;1,2,7,12;6,5,0;11,10,15,20,21,22,23,24,19,14,9,4,3
5,0,13,4;7,8,9,14,19,18;21,20,15,10,5,0;16,17,22,23,24;13,12,11,6,1,2,3,4
5,0,14,5;7,6,11;24,19,18;8,3,2,1,0,5,10;4,9,14,13,12,17,16,15;20,21,22,23
5,0,15,4;22,23,24,19,14,9,4,3,2,1,0,5;8,7,6;20,15,10,11,12,13,18;21,16,17
5,0,16,4;17,12,7,8,3;4,9,14,13,18;16,11,6;19,24,23,22,21,20,15,10,5,0,1,2
5,0,17,5;5,10,15,20,21;0,1,6;16,17,18,13,8;22,23,24,19,14,9;4,3,2,7,12,11
5,0,18,3;6,11,16,17,18,13,8,3;4,9,14,19,24,23,22,21,20,15,10;12,7,2,1,0,5
5,0,19,3;6,11,16,17,18,13,8;4,3,2,7,12;1,0,5,10,15,20,21,22,23,24,19,14,9
5,0,20,4;21,22,23,24,19,14;20,15,16,17,18;13,12,11,10,5,0,1,2,3,4;9,8,7,6
5,0,21,4;17,22,23,24,19,14,9,4,3,2,1,0,5;10,15,20,21;16,11,12,13,18;8,7,6
5,0,22,5;3,4,9,14,19,24,23,22,21;1,2,7,8,13;0,5,6,11,12;20,15,10;18,17,16
5,0,23,4;18,17,16,11,6;13,12,7,2,1;9,14,19,24,23,22,21,20,15,10,5,0;4,3,8
5,0,24,4;0,1,6,7,8;5,10,11,12,13,18,23,22,21;24,19,14,9,4,3,2;20,15,16,17
5,0,25,4;18,13,8,3;1,6,11,16,21;20,15,10,5,0;2,7,12,17,22,23,24,19,14,9,4
5,0,26,5;0,1,2,3;18,17,16,11;22,21,20,15,10,5,6,7;4,9,8;12,13,14,19,24,23
5,0,27,5;10,15,20;22,21,16,11;17,12,7,6;18,13,8,3,2,1,0,5;4,9,14,19,24,23
5,0,28,5;18,23,24;7,2,1,0,5,10,15,20,21,22,17;12,13,8,3,4;19,14,9;6,11,16
5,0,29,4;22,21,16,11,6;20,15,10,5,0,1,2,3,8,13,18,23;24,19,14,9,4;7,12,17
5,0,30,4;15,20,21,22,23,24,19,14;1,0,5,10,11,12,13,8,9;16,17,18;4,3,2,7,6
6,0,1,5;6,12,13,14,15,21;23,29,35,34,33,32,31,25;30,24,18,19,20,26,27,28,22;0,1,7,8,9,10,16;2,3,4,5,11,17
6,0,2,5;21,20,19,13,7,8,9;5,11,17,23,29,35,34,33,32,31,30;22,28,27,26,25,24,18;12,6,0,1,2,3;4,10,16,15,14
6,0,3,6;0,1,7,13;26,32,31,30;16,22,28,27;14,8,2,3,4,5,11,17,23,29,35,34,33;18,12,6;10,9,15,21,20,19,25,24
6,0,4,5;20,14,13,12,6,0,1,2,3;4,10,9,8,7;24,30,31,32,33,34,35,29;28,22,23,17,11,5;18,19,25,26,27,21,15,16
6,0,5,6;25,26,27;11,5,4,3,2,1,0,6,12;28,29,35;13,14,15;16,10,9,8,7;34,33,32,31,30,24,18,19,20,21,22,23,17
6,0,6,6;21,20,19,25;0,6,12,18;11,5,4,3,2,1,7;24,30,31,32,33,34,35,29,23,17,16,15;26,27,28,22;10,9,8,14,13
6,0,7,5;33,32,31,30,24,18;7,8,14,20,21,27;9,15,16,22,28;34,35,29,23,17,11,10;26,25,19,13,12,6,0,1,2,3,4,5
6,0,8,6;6,7,8,9,10,11,17,23,22,28,27,26,25,31;14,13,12;16,15,21;32,33,34,35,29;0,1,2,3,4,5;20,19,18,24,30
6,0,9,5;0,1,2,3,4,5,11,17,23;10,16,22,28,29;14,20,26,25;35,34,33,32,31,30,24,18,19,13;27,21,15,9,8,7,6,12
6,0,10,6;8,7,6;28,27,26;25,19,20;24,18,12,13,14,15,9;21,22,16,10;30,31,32,33,34,35,29,23,17,11,5,4,3,2,1,0
6,0,11,6;6,7,8,14;26,27,28,29,23,17,11;15,9,10,4,5;16,22,21,20,19,25;3,2,1,0;35,34,33,32,31,30,24,18,12,13
6,0,12,4;19,13,7,8,9,15,21,27,33,32,31,30,24;25,26,20,14;34,28,22,16,10;18,12,6,0,1,2,3,4,5,11,17,23,29,35
6,0,13,6;33,34,35,29,23,17,16,10,9;18,12,13;6,7,8,14,15;30,31,32,26,27,28,22;24,25,19,20,21;0,1,2,3,4,5,11
6,0,14,4;7,8,9,15,21,20;19,18,24,30,31,32,33,34,35,29,23,17,11,5,4,3,2,1,0;25,26,27,28,22,16,10;14,13,12,6
6,0,15,4;29,23,17,11,10,9,8,7,13;5,4,3,2,1,0,6,12,18,19,20,14,15,16,22,28;24,25,26,27,21;35,34,33,32,31,30
6,0,16,6;21,15,9;19,13,7,1;33,32,31,30;3,4,10,16,22,28,27;2,8,14,20,26,25,24,18,12,6,0;5,11,17,23,29,35,34
6,0,17,4;32,33,34,28,22,16,10,9,8,7,13,12,18,24;35,29,23,17,11,5,4,3,2,1,0,6;30,31,25,26,27,21,15;14,20,19
6,0,18,5;32,33,34,35,29,23,17,11,5,4,3,2,1,0,6,12,18,24;21,27,26;19,13,7,8,9,10,16,22,28;20,14,15;30,31,25
6,0,19,5;31,30,24,18,12,6,0,1;35,34,33,27,21,20;7,8,2,3,4,5,11,17,23,29;32,26,25,19,13,14,15;9,10,16,22,28
6,0,20,5;1,7,13,14,15,21,27,26,25;12,6,0;8,9,10,16,22,28,34,33,32,31;20,19,18,24,30;2,3,4,5,11,17,23,29,35
6,0,21,6;11,10,16,15,14;21,20,19,13,7,8,9;27,28,22,23,17;5,4,3,2,1,0,6,12,18;26,25,24;30,31,32,33,34,35,29
6,0,22,5;34,33,32,31,30,24,18,19,20,14,8,2,1,0,6;15,9,3,4,5,11,17,23;7,13,12;25,26,27,21,22,16,10;35,29,28
6,0,23,5;10,16,22,28;7,8,14,20,26,25;9,15,21,27,33,32,31,30,24,18,19;1,2,3,4,5,11,17,23,29,35,34;0,6,12,13
6,0,24,5;5,4,3;17,11,10,9,8,2,1,0,6,12,18,24,25,26;28,22,16,15,14;23,29,35,34,33,32,31,30;7,13,19,20,21,27
6,0,25,4;0,1,2,3,4,5,11,17,23,29,35,34,33,32;30,31,25,26,27,28,22,16,10,9,8,7,6;24,18,19,20,21;15,14,13,12
6,0,26,5;8,7,13,19,18,24,30,31,32,33,34,35,29,23;2,1,0,6,12;25,26,20,21;27,28,22,16,10;17,11,5,4,3,9,15,14
6,0,27,6;9,15,21,27,28,34,35;29,23,17,11,5,4,3,2,1,0;13,19,25,31,32,33;7,6,12,18,24,30;22,16,10;8,14,20,26
6,0,28,4;21,27,33;35,29,23,17,11,5,4,3,2,1,0,6,12,13,19,25;18,24,30,31,32,26,20,14,15;34,28,22,16,10,9,8,7
6,0,29,4;21,20,19,18,24,30;15,14,13,12,6,0,1,2,3,4,5,11,17,23,29,35,34,33,32,31,25;22,28,27,26;7,8,9,10,16
6,0,30,6;33,34,35,29,23,22,16,10;9,3,4,5,11,17;21,27,28;2,8,7,13,19;30,31,32,26,20,14,15;25,24,18,12,6,0,1
7,0,1,7;40,33,26;19,18,17,16,23,30,31,38,39,46;24,25,32;47,48,41,34,27,20,13,6,5,4,3;22,29,36,37;12,11,10,9,8,15;2,1,0,7,14,21,28,35,42,43,44,45
7,0,2,7;29,22,23,24,17,10,9,2;8,15,16;41,48,47,46,45,44,43,42,35,28,21,14,7,0,1;36,37,30,31,32;38,39,40,33,34,27,20,13,6,5;25,18,11,4,3;26,19,12
7,0,3,6;12,11,10,9,8,7;23,24,25;30,31,32,33,34,41,48,47,46,45,44,43,42,35;0,1,2,3,4,5,6,13,20,27,26;28,21,14,15,16,17,18,19;40,39,38,37,36,29,22
7,0,4,6;48,47,46,45,44,43,42,35,28,21,14,7,0,1,2,3,4,11;6,13,20,27,26;24,31,38,39,40;5,12,19;37,36,29,22,15,8,9,10;41,34,33,32,25,18,17,16,23,30
7,0,5,5;40,39,46;1,0,7,14,21,28;42,43,44,37,30,23,24,25,18;47,48,41,34,27,20,13,6,5,4,3,2,9,8;45,38,31,32,33,26,19,12,11,10,17,16,15,22,29,36,35
7,0,6,8;42,35,36,37;30,31,38,45,44,43;23,24,25,32,39,40;21,14,7,0;6,13,20,27,34,41,48,47,46;5,4,3,2,9,16,17,18,19,26,33;28,29,22,15,8,1;12,11,10
7,0,7,7;20,13,6,5,4,3,2,1,0,7,14,15,16,23,30;38,31,24,25,18;29,36,37;22,21,28,35,42,43,44,45,46,47,40;48,41,34,27,26,19,12,11;39,32,33;17,10,9,8
7,0,8,6;13,20,27,34,41,48,47,46,45;8,9,10;15,16,17,24,31,38,39,40,33,26,19,12;11,18,25,32;6,5,4,3,2,1,0,7,14,21,28,29,36;35,42,43,44,37,30,23,22
7,0,9,5;19,20,13,6,5,4,3;27,34,41,48,47,46,45,44,43,42,35,28,29,30,31,32;24,23,22,21,14,7,0,1,2,9,10;25,26,33,40,39,38,37,36;12,11,18,17,16,15,8
7,0,10,7;8,15,22,23,24,25;36,29,30,31;13,12,11,10;40,39,46,45;6,5,4,3,2,1,0,7,14,21,28,35,42,43,44,37,38;32,33,26,19,18,17,16,9;47,48,41,34,27,20
7,0,11,6;27,20,13,6,5,4,3,2,1,0,7,14,21,28,35;19,26,33,40,39;42,43,36,29,22,15,16,17;34,41,48,47,46,45,44,37,30,23,24;38,31,32,25,18;12,11,10,9,8
7,0,12,6;15,22,29,36,37,38,39,40;12,19,26,33;25,24,23,16,9,8;30,31,32;18,11,4,5,6,13,20,27;17,10,3,2,1,0,7,14,21,28,35,42,43,44,45,46,47,48,41,34
7,0,13,5;0,1,2,3,4,5,6,13,20,27,34,33;12,19,26,25,24,23,22,29,36;7,8,9,10;41,48,47,46,45,38;40,39,32,31,30,37,44,43,42,35,28,21,14,15,16,17,18,11
7,0,14,6;22,15,8,9,10,11,12,19;27,20,13,6,5,4,3,2,1,0,7,14,21,28;37,38,31,24,25,26,33,34,41,48;40,39,32;42,43,44,45,46,47;18,17,16,23,30,29,36,35
7,0,15,5;32,31,30,29,22,15,8;25,18,11,12,13;19,26,33,40,39,38,37,36;20,27,34,41,48,47,46,45,44,43,42,35,28,21,14,7,0,1,2,9,16,23;6,5,4,3,10,17,24
7,0,16,5;11,18,19,20,13,6;27,34,41,48,47,46,45,44,43,42,35,28,21,14,7,0,1,2,3;9,16,23,30,31,32;12,5,4;10,17,24,25,26,33,40,39,38,37,36,29,22,15,8
7,0,17,6;30,31,32;18,25,24,23,22,29,36,37,38,39,40,47,48;0,1,2,3;41,34,33,26,19,12;9,8,7,14,21,28,35,42,43,44,45,46;27,20,13,6,5,4,11,10,17,16,15
7,0,18,6;24,17,18,19,26,33,40,39,46;47,48,41,34,27,20;6,5,4,3,2,1,0,7,14,21,28,35,42,43,44,45;8,15,22,29,30;36,37,38,31,32,25;23,16,9,10,11,12,13
7,0,19,7;9,10,11,12,13,20,27,26;2,3,4,5,6;47,40,39,38,37,36;19,18,17,16,15,8;46,45,44,43,42,35,28,29,30,31,32;1,0,7,14,21,22,23,24,25;33,34,41,48
7,0,20,7;6,5,4,11;30,23,24,25,26,19,12,13;47,48,41,34,27,20;40,39,46,45,44,43,42,35;33,32,31,38,37,36,29,28,21;22,15,14,7,0,1,2,3,10,17,18;8,9,16
7,0,21,8;24,31,38,39,40,41;6,5,4,11;35,28,21,14,15,8,9;10,3,2,1,0,7;34,33,32;42,43,36,29,22,23,16,17,18,19,12,13;25,26,27,20;48,47,46,45,44,37,30
7,0,22,7;31,30,23;16,17,24;29,28,35,42,43,44,45,46,47;32,33,34,27,20,19,12,11,10,9,8,15,22;48,41,40,39,38,37,36;18,25,26;13,6,5,4,3,2,1,0,7,14,21
7,0,23,7;0,7,8;30,31,38;37,36,29,22,23,24,25,32,33;3,4,5,6;11,12,13,20,27,34,41,48,47;1,2,9,10,17,18,19,26;40,39,46,45,44,43,42,35,28,21,14,15,16
7,0,24,6;6,5,4,11,18,25,32,39;12,19,26,33,40;23,30,37,38;13,20,27,34,41,48,47,46,45,44,43,36,29,22,15,8;9,16,17,24,31;42,35,28,21,14,7,0,1,2,3,10
7,0,25,8;0,7,14;29,30,31;16,9,10,11,12;48,41,34,33,32;42,43,44,45,46;47,40,39,38,37,36,35,28,21,22,23;17,18,19;24,25,26,27,20,13,6,5,4,3,2,1,8,15
7,0,26,5;48,41,34,27,20,13,12,11,10;32,39,38,37,36,35;19,18,17,16,9;6,5,4,3,2,1,0,7,14,21,28,29,30,31;8,15,22,23,24,25,26,33,40,47,46,45,44,43,42
7,0,27,6;30,31,24;37,36,29,22,23,16;15,14,21,28,35,42,43,44,45,46,47,48;41,34,27,20,13,6,5;40,33,26,19,12,11,4,3,2,1,0,7;8,9,10,17,18,25,32,39,38
7,0,28,7;8,9,10,11,12,19;43,44,37,30,23,22;20,13,6,5,4,3,2,1,0,7;39,40,33,26;29,28,21,14,15,16,17,24,31,38,45,46,47,48,41,34,27;42,35,36;32,25,18
7,0,29,8;36,29,30,23,16,9;43,44,37,38,39,32,33,34,27,20,13,12;19,26,25,24,31;17,10,3,2,1,0,7,14;47,46,45;6,5,4,11,18;48,41,40;8,15,22,21,28,35,42
7,0,30,6;30,31,32,25,18,17;2,1,0,7,14,21,28,35,42,43,44,45,46,47,48,41;10,11,12,19,26;24,23,16;33,40,39,38,37,36,29,22,15,8,9;3,4,5,6,13,20,27,34
8,0,1,8;37,38,39,31,23,15,7,6,5;0,8,9,10,11;1,2,3,4,12,13;46,47,55,63,62,61,60,59,58,57,56,48,40,32,24,25;16,17,18,26,34;14,22,30,29,28,36,44,45,53,54;21,20,19,27,35,43,42,41,33;49,50,51,52
8,0,2,8;7,15,14;18,19,20,28,29,30,31;53,54,46,38,37,36,35,27,26;23,22,21,13,12,11,10,9,17,25,33,41,49,57,56;6,5,4,3,2,1,0,8,16,24,32,40,48;59,58,50,42,34;45,44,43;39,47,55,63,62,61,60,52,51
8,0,3,8;16,24,32,40,48,56,57,58,59,60,61;2,1,0;19,11,3,4,5,6,7,15,23,31,30,38,46,54;20,12,13,14;44,43,42,34,26,18,10,9,8;27,28,29,21,22;35,36,37,45,53,52,51,50,49,41,33,25,17;39,47,55,63,62
8,0,4,7;45,46,47,39,31;49,41,33;7,6,5,4,3,11,10,9,17,25,24,32,40,48,56,57,58,59,60,61,62;63,55,54,53,52,51,50,42,34,26,18,19,20,12,13,14;16,8,0,1,2;44,36,37,38,30,22,23,15;43,35,27,28,29,21
8,0,5,8;35,34,26,25;8,0,1,2,3,4;16,24,32,40,48,56,57,58,59,60,61,62,63,55,47,39,31,23,15,7,6,5;20,21,29,30,38,46,54;33,41,49,50,51,52;53,45,37,36,28,27,19,18,17;42,43,44;22,14,13,12,11,10,9
8,0,6,8;38,37,36,35;42,41,49;9,17,18,19,20,21,29,30,31,39,47,55,63,62,61,60,59;54,53,52,51,50,58,57,56,48,40,32;10,11,12,13,14,22;46,45,44,43;28,27,26,34;33,25,24,16,8,0,1,2,3,4,5,6,7,15,23
8,0,7,7;53,45,46,38,30,29,21,20,19,18,26,25;17,9,10,11,12,13,14,22;43,51,59,60,61,62,63;37,36,44,52;42,50,58,57,56,48,40,32,24,16,8,0,1,2,3,4,5,6;49,41,33,34,35,27,28;7,15,23,31,39,47,55,54
8,0,8,5;35,36,44,52,53,54,55,63;39,47,46,45,37,29,28,27;38,30,31,23,15,7,6,5,4,3,2,1,0,8,16,24,32,40,48,56,57,58,59,60,61,62;22,21,20,19,18,26,34,42,43;51,50,49,41,33,25,17,9,10,11,12,13,14
8,0,9,6;21,29,37,45,53;39,31,23,15,7,6,5,4,3,2,1,0,8,16,24,32,40,48,56,57,58,59,60;25,17,9,10,11,12,13,14,22,30,38,46,54,62,61;47,55,63;36,44,52,51,50,49,41,33,34,26,18,19,20;42,43,35,27,28
8,0,10,7;8,9,17,25,26,27,28,20,12,11,3;56,57,58,59,60,61,62,63,55,47,39,31,23,15,7,6,5,4;41,33,34,35,36,37,29,21,13;51,52,53,54;49,50,42,43,44,45,46,38,30,22,14;48,40,32,24,16;0,1,2,10,18,19
8,0,11,7;29,28,27,35;55,47,39,31,23,15,7,6,5,4,3,2,1,0,8,16,24,32,40,48,56,57;51,43,42,34,26,18,19,20,21;22,14,13,12,11,10,9,17,25,33,41,49,50,58,59;54,62,63;30,38,37,36,44,52,60;61,53,45,46
8,0,12,8;31,23,22,21,20;35,27,19,11,12,13,14;15,7,6,5,4,3,2,1,0,8,16,24,32,40,48,56,57;47,55,54,53,52,51;43,44,36,28,29,30,38,39;63,62,61,60,59,58,50,49,41,33,25,17,9,10;46,45,37;42,34,26,18
8,0,13,7;63,55,47,39,31,23,15,7,6,5,13,21,29,37,45,53,52;9,10,11,19,27,35;14,22,30,38,46,54,62,61,60,59,51;43,44,36,28,20,12,4,3,2;17,18,26,34,42,50,58,57,56;49,41,33,25;48,40,32,24,16,8,0,1
8,0,14,7;9,10,11,12,13,14,22;24,16,17,18,19,20,21;36,28,29,30,31,39,47,55,63,62,61,60,59,58,57,56,48,40,32,33;34,42,41;38,37,45,44,43,35,27,26,25;23,15,7,6,5,4,3,2,1,0,8;46,54,53,52,51,50,49
8,0,15,8;41,42,43,51,52,53,61,62;19,20,21,29,37,45,46,54;48,40,32,24,16,8,0;56,57,49;44,36,35,34,33,25,17,9,1;28,27,26,18,10,2,3,4,5,6,7,15,23,31,39,47,55,63;50,58,59,60;11,12,13,14,22,30,38
8,0,16,7;7,15,23,31,39,47,55,63;14,6,5,4;36,44,43,42;13,12,20,28,29,37,45,53,52,51,50,49,41,33,34,35;27,19,11,3,2,1,0,8,16,17;26,18,10,9;21,22,30,38,46,54,62,61,60,59,58,57,56,48,40,32,24,25
8,0,17,9;57,56,48;49,50,58,59,60,61,62,63,55,47,39,38,37,45,44;36,35,34,33,25,17;46,54,53,52,51,43,42,41,40,32,24,16;31,30,29,21;12,13,14,22,23;0,1,2;8,9,10,18,26,27,28,20;19,11,3,4,5,6,7,15
8,0,18,8;50,42,34,26;9,10,11,12,20;7,6,5;59,51,43,35,36,37,45,53,61,62,63,55,47,39,31,23;49,41,33,25,17,18,19,27,28,29,21,13,14,15;22,30,38,46,54;60,52,44;58,57,56,48,40,32,24,16,8,0,1,2,3,4
8,0,19,6;3,2,1,0,8,16,24,32,40,48,56,57,58,59,60;54,46,45,44,43,42,41,33,25,17,9;10,18,26,34,35,36,37,38;6,5,4,12,11,19,27,28,29,30,22,23;7,15,14,13,21,20;49,50,51,52,53,61,62,63,55,47,39,31
8,0,20,7;63,62,61,60,59;42,34,26,27,28;43,35,36,37,29,21,20,19;9,17,25,33,41,49,48,56;18,10,11,3,4,5,6,7,15,23,31,39,47,55,54,53,52,51,50,58,57;44,45,46,38,30,22,14,13,12;40,32,24,16,8,0,1,2
8,0,21,6;21,13,5,4,3,11;6,7,15,23,31,39,47,55,63,62,61,60,52,51,50,49,41,33,25,17,9,10;14,22,30,29,28;2,1,0,8,16,24,32,40,48,56,57,58,59;53,54,46,38,37,36,35,27,19,20,12;18,26,34,42,43,44,45
8,0,22,6;32,33,34,35,27,19,11,3,4,5,6,7,15,23,31,30,38,46,54;39,47,55,63,62,61,60,59,58,57,56,48,40;2,10,18,26,25,24,16,8,0;1,9,17;21,29,37,45,53,52,51,50,49;41,42,43,44,36,28,20,12,13,14,22
8,0,23,7;36,37,38,30;7,6,5,13,21,29,28,27,35,43,44,52,53;18,26,34,42;15,14,22;45,46,54;23,31,39,47,55,63,62,61,60,59,51,50,49,41,33,25,17,9,10,11;19,20,12,4,3,2,1,0,8,16,24,32,40,48,56,57,58
8,0,24,7;63,62,61,60,59,58,57,56,48;15,23,31,39,47,46,45,44,43,42,34,33,32,24,16,8,9,10,11,12,4;17,18,19,20,28,29;0,1,2,3;14,6,7;5,13,21,22,30,38,37,36,35,27,26,25;40,41,49,50,51,52,53,54,55
8,0,25,7;1,2,3,11,12,13,14,15,23,31,39,47,55,63,62,61,60,59,58;10,9,8,0;26,25,33,41,42,43;34,35,36,44;20,21,22,30,38,46,54,53,52,51,50,49,57,56;48,40,32,24,16,17,18,19,27,28,29,37,45;4,5,6,7
8,0,26,8;9,17,25,26,27,19;62,54,46,38,30,22,14,13,12,11;48,56,57,58,59,60;40,41,49,50;1,0,8,16,24,32,33,34,42,43,51,52,53,61;21,29,37,45,44;20,28,36,35;63,55,47,39,31,23,15,7,6,5,4,3,2,10,18
8,0,27,7;44,43,35,34,26,18,19,20,21,29;56,57,58,59,60,61;42,41,33,25,17,9,10,11,12,13,14,22;39,47,55,63,62;45,37,38,30,31,23,15,7,6,5,4,3,2,1,0,8,16,24,32,40,48,49,50,51,52;53,54,46;36,28,27
8,0,28,8;51,59,58,57,56,48,40;55,47,39,38,30,22,14,6,5,4,3,2,1,0,8,16,24,25,26,27,35,36;41,49,50;32,33,34,42,43,44,52,60;53,61,62,63;7,15,23,31;28,20,19,18,17;54,46,45,37,29,21,13,12,11,10,9
8,0,29,7;50,58,59,60,61,62,63,55,47,46,38,30,22,14;45,37,29,21,13;0,8,16,24,25,26;10,11,12,20,28,36,44;54,53,52,51,43;49,41,42,34,35,27,19,18,17,9,1,2,3,4,5,6,7,15,23,31,39;57,56,48,40,32,33
8,0,30,6;8,0,1,2,3,4,5,6,7,15,23,31,39,47,55,63,62,61;50,51,43,44,45,37,29,28,27,26,25,33;40,32,24,16,17,9,10,11,12,13;56,57,58,59,60,52,53,54,46,38,30;36,35,34,42,41,49,48;18,19,20,21,22,14
9,0,1,9;9,10,19,20,21,22,31,40,39,38,37,36,45,54,63,72,73;0,1,2,3,4,5,6,7,8,17,26,35,44;23,32,41,50;18,27,28,29,30;62,71,80,79,78,77,76,75,74,65,64,55,46;67,66,57,56,47;16,25,34,43,52,53;61,60,51,42,33,24,15,14,13,12,11;70,69,68,59,58,49,48
9,0,2,8;63,72,73,74,75,76,77,78,79,80,71,62,53,44,35,26,17,8,7,6;30,31,22,13,4,3;40,41,32,23,14,5;2,11,10,19,28,37,38,39,48,49,50;12,21,20,29;46,47,56,57,58,59,60,51,42,33,24,15;1,0,9,18,27,36,45,54,55;64,65,66,67,68,69,70,61,52,43,34,25,16
9,0,3,9;49,50,41;60,59,58,57,48;46,37,28,29,20;32,23,24,25,34,43,44,53,62,71,80,79,78,77,76,75,74,73,72,63,54;9,0,1,2,3,4,5,6,7,8,17,26,35;64,55,56,47,38,39,40,31;33,42,51,52,61,70,69,68,67,66,65;30,21,22,13,14,15,16;45,36,27,18,19,10,11,12
9,0,4,8;59,58,49,40,39,30,21,12,3;72,73,64,55,46,37,28,19,10,9,0;50,41,32;18,27,36,45,54,63;14,15,16,25,34,43,52,61,70,69,68,67,66,57,48,47,38,29,20,11,2,1;78,77,76,75,74,65,56;60,51,42,33,24,23,22,31;13,4,5,6,7,8,17,26,35,44,53,62,71,80,79
9,0,5,8;1,0,9,18,27,36,45,54,63,72,73,74,75,76,77,78,79,80,71,62,53,52,51,50,49,48;70,69,68,67,66,65,64,55;14,5,6;33,32,31,30,29,20;12,21,22,23,24,15;8,7,16,25,34,43,42,41,40,39,38,37,28,19,10,11,2,3,4,13;61,60,59,58,57,56,47,46;17,26,35,44
9,0,6,8;0,9,18,19,28,29;49,40,39;13,12,3,2,1;56,65,66,67,68,69,70,61,52,43,34,25,16,15,14,23,22;4,5,6,7,8,17,26,35,44,53,62,71,80,79,78,77,76,75,74,73,64,55;46,45,54,63,72;24,33,42,51,60;10,11,20,21,30,31,32,41,50,59,58,57,48,47,38,37,36,27
9,0,7,9;51,50,49,40,31,22,13;46,37,38,29,20,21,12,3,4,5,6,7,8,17,26,35,44;10,19,28,27,36,45,54;55,56,47,48,39,30;41,32,23,14,15,16,25,34,43,52,53,62,71,80,79,78,77,76,75,74,73,72,63;18,9,0,1,2,11;24,33,42;57,58,59,60,61;70,69,68,67,66,65,64
9,0,8,9;74,73,72,63;50,49,48;24,23,22,21,30;69,68,67;79,78,77,76,75,66,65,64,55,54,45,36,27,18,9,0;2,3,12,13,14,15,16,25,34,33,32,31;19,28,37,46,47,56,57,58,59,60,51,52,53,62;61,70,71,80;4,5,6,7,8,17,26,35,44,43,42,41,40,39,38,29,20,11,10,1
9,0,9,8;40,49,48,57;72,73,74,75,76,77;60,59,58,67,66,65,64,63,54,45,36,27,18,9,0,1,2,3,4,5,6,7,8;56,47,38,39,30,31;55,46,37,28,19,10,11,12,13,14,15,16,17,26,35,44,53,62,71,80,79,78;68,69,70,61,52,51,50,41;29,20,21,22,23,32,33;42,43,34,25,24
9,0,10,9;60,51,42,33,24,23,22,21,20,19,10,1,0;40,39,38,47,46;55,56,57,48;63,64,65,66;27,18,9;11,12,13,14,15,16,25,34,43,52,61,70,69;72,73,74,75,76,67,58,49,50,41;2,3,4,5,6,7,8,17,26,35,44,53,62,71,80,79,78,77,68,59;32,31,30,29,28,37,36,45,54
9,0,11,8;79,80,71,62,53,44,35,26,17,8,7,6,5,4,3;9,18,27,36,45;20,21,22,23,24;42,51,50,49,58,57,66;77,78,69,70;2,11,12,13,14,15,16,25,34,33,32,41,40,39,48,47,56,65,64;43,52,61,60,59,68,67,76,75,74,73,72,63,54,55,46,37,38,29,30,31;0,1,10,19,28
9,0,12,8;18,9,0,1,2,3,4,5,6,7,8;17,16,15,24,33,42,41,40,39,38,47,56,57,58,67,68,69,70,71,62,53,44,35;27,36,45,54,63,72,73,74;13,22,21,20;26,25,34,43,52,51;19,10,11,12;48,49,50,59,60,61;14,23,32,31,30,29,28,37,46,55,64,65,66,75,76,77,78,79,80
9,0,13,7;38,29,20,21,22,23,32,41,50,59,60;56,47,48,39,30;1,0,9,18,27;53,62,71,80,79,78,77,76,75,74,73,72,63,54,45,36,37,28,19,10,11,2,3,4,5,6,7,8,17,26,35;57,58,49,40,31;24,33,42,51,52,61,70,69,68,67,66,65,64,55,46;44,43,34,25,16,15,14,13,12
9,0,14,8;4,5,6,7,8;24,15,16,17,26,35,44,53,62,71,80,79,78,77,76,75,74,73,72,63,54,45,36,27,18,9,0,1,2,3,12,21,22;25,34,43,52,61,70,69,68,67,66,65,64;55,56,57,58,59,60,51,42,33;10,19,28,37,46,47,48,49,50;38,39,40,41;11,20,29,30,31,32;13,14,23
9,0,15,7;42,41,50,59,58;39,30,21,22,23,24,25,26,17,8,7,6,5,4,3;43,52,51,60,69,68,67,66,57,48,49;80,71,62,53,44,35,34,33,32,31,40;16,15,14,13,12,11,2,1,0,9,18,27,28,37,46,55,64,73,74,75,76,77,78,79,70,61;36,45,54,63,72;65,56,47,38,29,20,19,10
9,0,16,7;30,31,32,33,24;56,65,66,67,68;70,69,60,51,52,53,44,35,26,17,8,7,6,5,4,3,2,1,0,9,18,27,36,45,54,63,72;25,34,43,42,41,50,59,58,57,48,47,46,55,64,73,74,75,76,77,78,79,80;16,15,14,13,12,11,10,19,28,37,38,39,40,49;23,22,21,20,29;61,62,71
9,0,17,9;34,35,26,17,8,7,6,5,4,3,2,1,0,9,18,27,36,45,54,63,72,73,74,75,76;58,67,68,69,70,71,62,53;51,42,33,32,31,30,39,48,49;80,79,78,77;40,41,50;25,16,15,14,13;59,60,61,52,43,44;24,23,22,21,20,29,38,47,56,57,66;65,64,55,46,37,28,19,10,11,12
9,0,18,8;56,57,66,75,76,77,78,79,80,71,62,53,44,35,26,17,8,7,6,5,4,3,2;51,42,33,24,23,22,21,20,19,28;74,65,64,55,46,37,38,29,30,31,32,41,50,49;47,48,39,40;70,61,60,59,58;52,43,34,25,16,15,14,13,12,11,10,1;69,68,67;0,9,18,27,36,45,54,63,72,73
9,0,19,8;74,75,76,77,78,79,80;47,48,49,58,59,60,61,62,53,44,35,26,17,16,15,14,13,12,11,10,19;67,68,69,70,71;38,39,40,41,50,51,52,43,34,25,24,23,22,21,20;8,7,6,5,4,3,2,1,0,9,18,27,36,45,46;73,64,65;66,57,56,55,54,63,72;37,28,29,30,31,32,33,42
9,0,20,7;59,60,51;66,65,56,47,48,39,40,41,42,43,34,25,24,23,22,21,20;75,76,67,68,69,70,61,52;74,73,72,63,54,45,36,27,18,9,0,1,2,3,4,5,6,7,8;38,29,30,31,32,33;77,78,79,80,71,62,53,44,35,26,17,16,15,14,13,12,11,10,19,28,37,46,55,64;57,58,49,50
9,0,21,10;2,11,12,13,22,23;37,36,27,18,9,0;61,60,51,50,41,32,31,30,21,20;80,79,78,77,76,75,74,73,72,63,54,55,56,57,48,39,38,29,28,19,10,1;59,58,49,40;45,46,47;14,15,24,33,42,43,52;64,65,66,67,68,69,70,71,62,53,44,35,34,25,16;7,8,17,26;6,5,4,3
9,0,22,7;16,15,14,13,12;30,21,22,23,24,25,34,43,52,61,60,59;38,29,20;51,42,33,32,31,40,39,48,47,46,45,36,27,18,9,0,1;70,69,68,67,66,65,64,63;37,28,19,10,11,2,3,4,5,6,7,8,17,26,35,44,53,62,71,80,79,78,77,76,75,74,73,72;54,55,56,57,58,49,50,41
9,0,23,9;30,39,48,49,50,59;0,9,10,19,20,29,38,47,56,57,58,67,68,69;78,79,80,71,62,53,44,35,26,17,8,7,6,5,4,3;77,76,75,66,65,64,55,46,37,28,27,18;13,14,23,32,41;16,15,24,33,42,51,60,61,70;74,73,72,63,54,45,36;52,43,34,25;40,31,22,21,12,11,2,1
9,0,24,7;15,6,7;34,43,52,61,60,59,58,57,56,55,46,37,28,19,20,21,12;5,14,23,32,41,40,39;29,38,47,48,49,50,51,42,33,24,25,16,17,8;70,69,68,67,66,65,64;26,35,44,53,62,71,80,79,78,77,76,75,74,73,72,63,54,45,36,27,18,9,0,1;10,11,2,3,4,13,22,31,30
9,0,25,7;56,57,58,59,60,51,42;36,45,54,63,72,73,74,75,76,77,78,79,80,71,62,53,44,35,26,25,16,15,14,13,12,21,20,29;1,0,9,18,27;37,46,55,64,65,66,67,68,69,70,61,52,43,34,33,24,23;40,39,30;17,8,7,6,5,4,3,2,11,10,19,28;22,31,32,41,50,49,48,47,38
9,0,26,8;20,21,12,13,14,15;33,34,25,16;3,4,5,6,7,8,17,26,35,44,43,42;80,71,62,53,52,51,50,41,32;39,30,29;24,23,22,31,40,49,48;10,19,28,37,38,47,56,57,58,59,60,61,70,79,78,77,76,75,74,73,72,63,54;11,2,1,0,9,18,27,36,45,46,55,64,65,66,67,68,69
9,0,27,9;38,47,48,49,50;71,80,79,78,77,76,75;13,14,23,24,25,26,17,8,7;52,51,60,59,58,57,56,65,74,73,72,63,54,45,36,27,28,19,10,11;37,46,55,64;34,35,44,53,62,61,70,69,68,67,66;12,21,22,31,32,33,42,43;18,9,0,1,2,3,4,5,6,15,16;20,29,30,39,40,41
9,0,28,8;20,21,22,31;10,19,28,37,46,55,64,65,66,75,76,77,78,79,80,71,62,53,44,35,26,17,8,7,6,5,4,3,12;9,0,1,2,11;16,25,34,43,52,61,70,69,68,59,50,49,48;74,73,72,63,54,45,36,27,18;13,14,23,32,41,40,39,30,29;38,47,56,57,58,67;15,24,33,42,51,60
9,0,29,9;80,79,78,77,76,75,74,73,72,63,54,45;10,19,28,29;16,25,34,43,42,41,50;36,27,18,9,0,1,2,3;51,52,53,44,35,26,17,8,7,6,15,24,33,32,31,40,49,48,47;30,39,38,37,46,55,64,65,66,67,68,69,70;56,57,58,59,60,61,62,71;5,14,23,22,21;4,13,12,11,20
9,0,30,8;28,29,20,11,12,13,22,23,24,33,42,51,60,59,58,57,48;10,19,18,27,36,37,38,39;56,65,66,67,68,69,70,61,52,43,34,25,16,15,14,5,4,3,2,1,0,9;21,30,31,40;45,54,63,72;73,64,55,46,47;74,75,76,77,78,79,80,71,62,53,44,35,26,17,8,7,6;49,50,41,32
