8,0,1,4;27,28,29,30,31,39,47,55,63,62;61,60,52,51,50,49;14,13,12,11,10,9,17,25,33,41,42,43,44,45,53,54;59,58,57,56,48,40,32,24,16,8,0,1,2,3,4,5,6,7,15,23,22,21,20,19,18,26,34,35,36,37,38,46
8,0,2,4;54,53,52,51,50,49,41,33,25,17,9,10,11,12,13;21,20,19,18,26,34,42,43,44,45,46,47,55,63,62,61,60,59,58,57,56,48,40,32,24,16,8,0,1,2,3,4,5,6;23,31,39,38,37,36,35;7,15,14,22,30,29,28,27
8,0,3,6;49,41,33,32,24,16,8,0,1,2,3,4,5,6,7;43,51,52,53,45,37,29,28,20;21,22,30,38,46,54,62,61,60,59;40,48,56,57,58,50,42,34,26,25,17,9;63,55,47,39,31,23,15,14,13,12,11,10;18,19,27,35,36,44
8,0,4,4;27,35,34,33,32,40,48,56,57,58,59,60,61,62,63,55,47,39,31,23,15,7;45,37,29,21,13,12,11,10,9,17,25,24;26,18,19,20,28,36,44,43,42,41,49;50,51,52,53,54,46,38,30,22,14,6,5,4,3,2,1,0,8,16
8,0,5,5;32,40,41,49,50,51,52,53,45,37,29,21,13,5,6,7,15,23,31,39,47,55,63;42,34,33,25,24,16,8,0;14,22,30,38,46,54,62,61,60,59,58,57,56,48;44,36,28,20,19,11,10;12,4,3,2,1,9,17,18,26,27,35,43
8,0,6,5;48,56,57,58,59,60,61,62,63,55,47,39,31,30,29,28,27,35;34,26,18,19,20,21,22,23,15;45,53,52,51,50,49,41,40,32,24,16,8,0,1,2,3,4,5;54,46,38,37,36,44,43,42;33,25,17,9,10,11,12,13,14,6,7
8,0,7,5;35,36,37,38,39,31,23,15,7,6;54,53,61,60,59,51,50,49,41,33,25,17,9,10,11,12;52,44,45,46,47,55,63,62;14,22,30,29,28,27;58,57,56,48,40,32,24,16,8,0,1,2,3,4,5,13,21,20,19,18,26,34,42,43
8,0,8,5;20,21,29,37,45,53,52,51,50,49,41,33,32,24,16,8,0,1;40,48,56,57,58,59,60,61,62,54,46,38,30,22,14,13;3,2,10,9,17,25;27,28,36,44,43,42;63,55,47,39,31,23,15,7,6,5,4,12,11,19,18,26,34,35
8,0,9,4;62,54,46,38,30,22,14,13,12,11,10,18,26,34,35,43;28,36,44,52,51,50,49;0,8,16,24,32,40,48,56,57,58,59,60,61,53,45,37,29,21,20,19,27;63,55,47,39,31,23,15,7,6,5,4,3,2,1,9,17,25,33,41,42
8,0,10,4;28,27,35,43,51,59,60,61,62,63,55,47;31,23,15,7,6,5,4,3,2,1,0,8,16,24,32,40,48,56,57,58,50,42,34,26,18,19,20,21,29,37,45;36,44,52,53,54,46;39,38,30,22,14,13,12,11,10,9,17,25,33,41,49
9,0,11,4;40,39,48,57,66,65,74;75,76,67,58,49,50,41,32,31,30,29,38,47,56,55,64,73;36,27,18,9,0,1,2,3,4,5,6,7,8,17,26,35,44,53,62,71,80,79,78,77,68,59,60,51,42,33,24,23,22,21,20;72,63,54,45,46,37,28,19,10,11,12,13,14,15,16,25,34,43,52,61,70,69
9,0,12,5;11,2,3,4,5,6,15,24,33,42,51,60,59,58,57,56,47;22,31,30,29,28,27,18,9;40,39,38,37,36,45,54,63,72,73,74,75,76,77,78,79,80,71,62,53,44,35,26,17;46,55,64,65,66,67,68,69,70,61,52,43,34,25,16,7,8;0,1,10,19,20,21,12,13,14,23,32,41,50,49,48
9,0,13,4;40,31,22,13,4,5,6,7,8;14,23,32,41,50,49,48,39,30,21,12,3,2,1,0,9;27,36,45,54,63,72,73,74,75,76,77,78,79,80,71,62,53,44,35,26,17,16,15,24,33,42,51,60,59,58,57,56,47,38,29,20,11,10;18,19,28,37,46,55,64,65,66,67,68,69,70,61,52,43,34,25
9,0,14,4;70,69,68,67,66,65,64,55,46,37,28,19,10,11,12,13,14,15,16,25,26;44,35,34,33,32,31,30,39,48,49,50,51;17,8,7,6,5,4,3,2,1,0,9,18,27,36,45,54,63,72,73,74,75,76,77,78,79,80,71,62,53,52,43,42,41,40;24,23,22,21,20,29,38,47,56,57,58,59,60,61
9,0,15,5;56,57,58,59,60,51,52,43,34,25,16,15,14,13,12;30,29,28,27,36,45,54,63,72,73,74,75,76,77,78,79,80,71;41,50,49,48,47,46,55,64,65,66,67,68,69,70,61,62,53,44,35,26,17,8,7,6,5,4,3,2,1,0,9,18,19;10,11,20,21,22,23,24,33,42;37,38,39,40,31,32
9,0,16,5;29,38,47,56,57,58,67,76,75,74,73,72,63,54,45,36,27,18,9,0,1,2,3,4,5,6,7,8,17;20,21,22,23,24,25,34,43,52,61,70,69;66,65,64,55,46,37,28,19,10,11,12,13,14,15,16;49,48,39,30,31,32,33,42,51,60;26,35,44,53,62,71,80,79,78,77,68,59,50,41,40
9,0,17,4;73,64,65,66,67,68,59,50,41,32,31,30,39,48,47,46,45,36,27,18,9,0,1,2,3,4,5,6,7,8,17,26,35,44,53,62,71,80,79;70,61,52,43,34,25,16,15,14,13,12,11,10,19,28;40,49,58,57,56,55,54,63,72;74,75,76,77,78,69,60,51,42,33,24,23,22,21,20,29,38,37
9,0,18,5;23,32,33,34,25,16,7,6,5;4,3,12,11,10,19,28,37,46,55,64,65,66,67,68,69,70,61;40,41,42,43,44,35,26,17,8;24,15,14,13,22,21,20,29,38,47,56,57,58,59,60,51,52,53,62,71,80,79,78,77,76,75,74,73,72,63,54,45,36,27,18,9,0,1,2;50,49,48,39,30,31
9,0,19,5;49,48,47,46,37,28,19,10;72,63,54,45,36,27,18,9,0,1,2,3,12,21,30,31,32,33,42,51,60,69,68,67,66,65;11,20,29,38,39,40,41,50,59,58,57,56,55,64,73;70,61,52,43,34,25,16,15,14;74,75,76,77,78,79,80,71,62,53,44,35,26,17,8,7,6,5,4,13,22,23,24
9,0,20,5;64,55,46,37,28,19,10,11,12,13,14,15,16,25,34;70,69,60,59,58,57,48,39;68,67,66,65,56,47,38,29,20,21,22,23,24,33;30,31,32,41,42,43,44,53;35,26,17,8,7,6,5,4,3,2,1,0,9,18,27,36,45,54,63,72,73,74,75,76,77,78,79,80,71,62,61,52,51,50,49,40
10,0,21,5;85,86,87,88,78,68,58,48,38,28,18,17,16,15,14,13,12,11,21,31,41,51;80,81,82,83,84,74,64,54;70,71,72,73,63,53,43,33,34,35,36,46,56,66,67;90,91,92,93,94,95,96,97,98,99,89,79,69,59,49,39,29,19,9,8,7,6,5,4,3,2,1,0,10,20,30,40,50,60,61,62,52,42,32,22,23,24,25,26,27,37,47,57;77,76,75,65,55,45,44
10,0,22,7;9,8,18,28,38,48,58,68,67,77;44,45,55,65,75,85,95,96,97,98,99,89;26,16,15,14,13,12,11,21,31,41,51,61,71,81,82;19,29,39,49,59,69,79,78,88,87,86,76,66,56,46,36,35,34,33,43,53,63,73,83;54,64,74,84,94,93,92,91,90,80,70;57,47,37,27,17,7,6,5,4,3,2,1,0,10,20,30,40,50,60;72,62,52,42,32,22,23,24,25
10,0,23,7;27,17,16,15,25,24,23,22,32,42,52,62,72,73,74,75,76,77,87,97,96,95,94,93,92,91,90,80,70,60,50,40,30,20,10,0,1,2,3,4;64,63,53,43,33,34,35,36,26;65,55,56,57,58,59,69,79,89;9,19,29,39,49,48,47,46,45,44,54;66,67,68,78,88,98,99;37,38,28,18,8,7,6,5;14,13,12,11,21,31,41,51,61,71,81,82,83,84,85,86
10,0,24,5;88,87,86,85,84,83,82,81,71,61,51,41,31,21,11,12,2,3,4,5,6,16;1,0,10,20,30,40,50,60,70,80,90,91,92,93,94,95,96,97,98,99,89,79,69,59,58,57,67,66,65,64,54,44,45,35,36,37,38,28,18;7,17,27,26,25,24,34,33,43,53,63,73,74,75,76,77,78,68;15,14,13,23,22,32,42,52,62,72;8,9,19,29,39,49,48,47,46,56,55
10,0,25,7;72,62,52,42,43,44,45,46,36,37,27;67,77,76,75,85,95,96,97,98,99,89,79,69,59,49,39,29,19,9,8,7,6,5,4;21,20,30,40,50,60,61,71,81,82,83,73,63,53,54,55,56,57,47;0,10,11,12,22,23,24;66,65,64,74,84,94,93,92,91,90,80,70;51,41,31,32,33,34,35,25,26;86,87,88,78,68,58,48,38,28,18,17,16,15,14,13,3,2,1
10,0,26,7;77,67,57,56,46,36,35,25,24,23,22;72,73,63,64,65,66;11,21,31,32,33,34,44,45,55;12,13,14,15,16,17,18,28,38;94,93,92,91,90,80,70,60,50,51,41,42,43,53,54;52,62,61,71,81,82,83,84,85,95,96,97,98,99,89,79,69,59,49,39,29,19,9,8,7,6,5,4,3,2,1,0,10,20,30,40;26,27,37,47,48,58,68,78,88,87,86,76,75,74
10,0,27,6;13,23,33,34,35,36,37;45,44,43,42,32,22,12,2,3;10,20,30,40,50,60,61,62,63,64,65,66,67,57;0,1,11,21,31,41,51,52,53,54,55,56,46,47,48,38,28,27,26,25,24,14,4,5,6,7,8,9;69,79,89,88,87,86,85,84,83,82,81;99,98,97,96,95,94,93,92,91,90,80,70,71,72,73,74,75,76,77,78,68,58,59,49,39,29,19,18,17,16,15
10,0,28,6;1,0,10,20,30,40,50,60,70,80,90,91,92,93,94,84,74,73,72,62,52,42,32,22;54,55,56,66,76,86;9,19,18,17,16,15,14,13,23,33,34,35,36,37,38,48,58,68,78,88;95,85,75,65,64,63,53,43,44,45,46,47,57,67,77,87;83,82,81,71,61,51,41,31,21,11,12,2,3,4,5,6,7,8;96,97,98,99,89,79,69,59,49,39,29,28,27,26,25,24
10,0,29,5;45,44,54,53,63,73,83,93,94,95,96,97,98;77,87,86,85,84,74,64;43,33,34,35,36,46,56,55,65,75,76;66,67,57,47,37,27,26,25,24,23,22,32,42,52,62,72,82,92,91,90,80,70,60,50,40,30,20,10,0,1,2,3,4,5,6,7,8,9,19,29,39,49,59,69,79;99,89,88,78,68,58,48,38,28,18,17,16,15,14,13,12,11,21,31,41,51,61,71,81
10,0,30,6;19,9,8,7,6,5,4,3,2,1,0,10,20,30,40,41,51,52,53,54,55,45,35,34;47,57,58,68,78,88,87,86,85,84,83,82,81;39,29,28,18,17,16,15,14,13,12,22;27,37,38,48,49,59,69,79,89,99,98,97,96,95,94,93,92,91,90,80,70,71,72,73,74,75,76,77,67;11,21,31,32,42,43,44;50,60,61,62,63,64,65,66,56,46,36,26,25,24,23,33
