10,0,1,7;99,89,79,69,59,49,39,29,19,9,8,7,6,5,4,3,2,1,0,10,20,30,40;46,36,35;34,44,45,55,56,66,76,75,74,84,83,82;50,51,41,31,21,11,12,13,14,15,16,17,18,28,38,48,58,68,78,88,98,97,96,95,94,93;85,86,87,77,67,57,47,37,27,26,25,24,23,22,32,42,52,62,61,60,70,80,90;92,91,81,71,72,73,63,64,65;33,43,53,54
11,0,2,8;48,47,46,45,34,23,12,13,14,15,16,17,18,19,20,31,42,53,64,75,86,97,108,107,106,105,94,93,92,103,114;70,69,68,79,90,101,112,113;110,111,100,89,78,67,56,57,58,59,60;102,91,80,81,82,71,72,61,50,49,38,37,36;83,84,95;99,88,77,66,55,44,33,22,11,0,1,2,3,4,5,6,7,8,9,10,21,32,43,54,65,76,87,98,109,120,119,118,117,116,115,104;73,62,51,40,39;35,24,25,26,27,28,29,30,41,52,63,74,85,96
12,0,3,7;65,77,89,90,102,114,126,138,139,140,141,142,143,131,119,107,95,83,71,59,47,35,23,11,10,9,8,7,6,5,4,3,2,1,0,12,24,36,48,60,72,84,96,108,120,132,133,134,135;123,122,121,109,97,85,73,61,49,37,25,13,14,15,16,17,18,19,20,21,22,34,46,58,70,82,94;117,116,104,92,80,68,67,55,54,53,52,64,63,75,87,99,98;51,39,40,41,42,43,44,56;86,74,62,50,38,26,27,28,29,30,31,32,33,45,57,69,81,93,105,106,118,130,129,128,127,115,103,91,79,78,66;76,88,100,101,113,125,137,136;124,112,111,110
11,0,4,8;45,34,35,36,37,38,39,40,41,52,63,74,85,96,95;30,29,28,27,26,25,24;61,72,71,70,81,80,91;66,55,44,33,22,11,0,1,2,3,4,5,6,7,8,9,10,21,32,43,54,65,76,87,98,109,120,119,118,117,116;48,47,46,57,56,67,78,89;90,79,68,69,58,59,60,49,50,51,62,73,84,83,94,105,106,107,108,97,86,75,64,53,42,31,20,19,18,17,16,15,14,13,12,23;77,88,99,110,111,112,113,114,115,104,93,82;100,101,102,103,92
10,0,5,7;57,56,66,76,75,74,73;27,26,16,15,14,13,12,11,21,31,41,51,61,71,81,82,83,84,85,86,87,88,78;34,44,54,64,63,62,72;42,32,22;58,48,47,46,45,55,65;52,53,43,33,23,24,25,35,36,37,38,28,18,17,7,6,5,4,3,2,1,0,10,20,30,40,50,60,70,80,90,91,92,93,94,95,96,97,98,99,89,79;77,67,68,69,59,49,39,29,19,9,8
11,0,6,7;39,50,49,48,59,70,81,80,91,102,103,104,105,106,117;84,85,86,75,64,53,42,31,20,19,18,17,16,15,14,13,12,23,34,45,56,67,78,89;109,120,119,118,107,96,95,94,83,72,73,74,63,52,41,30,29,28,27,26,25,24,35,46,57,68,79,90,101,100,111;116,115,114,113,112;69,58,47,36,37,38;40,51,62,61,60,71,82,93,92;108,97,98,87,76,65,54,43,32,21,10,9,8,7,6,5,4,3,2,1,0,11,22,33,44,55,66,77,88,99,110
12,0,7,7;65,77,76,88,100,112,124,136,137,138,139,140,141,142,143,131,119,107,95,83,71,59,47,35,23,11,10,9,8,7,6,5,4,3,2,1,0,12,24,36,48,60,72,73,85,97,109,121,133;134,122,110,98,86,74,62,61,49,37,25,13,14,15,16,17,18,19,20,21,22,34,46,58,70,82;81,69,57,45,33,32,31,30,29,28,27,26,38,50,51,63,75,87,99,111,123,135;64,52,53,54,55,67,79,91,103,104;102,114,115,116,117,105,93,92,80,68,56,44,43,42,41,40,39;94,106,118,130,129,128,127,126,125,113,101,89,90,78,66;132,120,108,96,84
11,0,8,6;12,13,14,15,16,17,18,19,20,31,42,53,64,75,86,97,96,95,94,93,82,71,60,59,58,57,68,79,90;73,62,51,40,39,38,37,36,35,34,33,44,55,66,77,88,99,110,111;112,101,100,89,78,67,56,45,46,47,48,49,50,61,72,83,84;108,107,106,105,104,103,102,91,80;85,74,63,52,41,30,29,28,27,26,25,24,23,22,11,0,1,2,3,4,5,6,7,8,9,10,21,32,43,54,65,76,87,98,109,120,119,118,117,116,115,114,113;69,70,81,92
10,0,9,7;90,91,81,71,61,62,52,53,54,55,56,46,36,35,34,33,32,31,21,11,12,13,14,15,16,17,18,28,38,48,58,68,69;83,84,85,86,87,88,78,79;40,30,20,10,0,1,2,3,4,5,6,7,8,9,19,29,39,49,59;66,65,64,63;22,23,24,25,26,27,37,47,57,67,77,76,75,74,73;45,44,43,42,41,51,50,60,70,80;89,99,98,97,96,95,94,93,92,82,72
11,0,10,7;78,89,90,91,92,93,94,95,96,85,74,73,72,71,70,69,58,57,56,55,44,33,22,11,0,1,2;84,83,82,81,80,79,68,67,66;37,36,47,46,45,34,23,12,13,14,3,4,5,6,7,8,9,10,21,32,43,54,53,52,51,50,49;30,29,28,27,38;77,88,99,110,111,112,113,114,115,116,117,118,119,120,109,98,87,76,65,64,63,62,61,60,59,48;100,101,102,103,104,105,106,107,108,97,86,75;39,40,41,42,31,20,19,18,17,16,15,26,25,24,35
12,0,11,7;63,62,74,86,98,110;11,10,9,8,7,6,5,4,3,2,1,0,12,24,36,48,60,72,84,96,108,120,132,133,134,135,136,137,138,139,140,141,142,143,131,119,107,95,83,71,59,58,57,56,68,80,92,104,103,102,101,100,88,76,77,78,66,54,42,41,40,39;70,69,81,93,105,117,116,115,114,113,112,111,99,87,75;89,90,91,79,67,55,43,44,45;35,23,22,21,20,19,18,17,16,15,14,13,25,37,49,61,73,85,97,109,121,122,123,124,125,126,127,128,129,130,118,106,94,82;47,46,34,33,32,31,30,29,28,27,26,38,50,51,52;64,65,53
11,0,12,8;58,47,48,49,50,51,62,73,84,83,94,93,92,91,90;107,108,97,86,75,64,53,42,43,32,21,10,9,8,7,6,5,4,3,2,1,0;66,77,88,99,110,111,112,113,102,103,104,105,106,95,96,85,74,63,52,41,40,39,38,37,36,35,34,33,22,11,12,13,14,15,16,17,18,19,20,31;71,82,81,80,79,78,89,100,101;72,61,60,59,70,69,68,57,46,45;44,55,56,67;30,29,28,27,26,25,24,23;114,115,116,117,118,119,120,109,98,87,76,65,54
10,0,13,7;36,35,45,55,65,64,63,53,43,33;57,58,48,38,28,18,17,16,15,14,4;34,44,54;3,13,23,24,25,26,27,37,47,46,56,66,76,75;11,21,31,41,51,61,71,81,82,83,84,85,86,87,88,78,79,69,59,49,39,29,19,9,8,7,6,5;68,67,77;74,73,72,62,52,42,32,22,12,2,1,0,10,20,30,40,50,60,70,80,90,91,92,93,94,95,96,97,98,99,89
11,0,14,7;41,42,53,64,65,76,87,98,97,96,85,84,73,62,61,50,39,28,27,26,25,24,35,46,57,68,79,80,81,82,93,104,105,116,117,118,119;102,101,100,89,78,67,56,45,34,23,12,13,14,15,16,17,18,19,20,31;86,75,74,63,52,51,40,29,30;115,114,113,112,111,110,99,88,77,66,55,44,33,22,11,0,1,2,3,4,5,6,7,8,9,10,21,32,43,54;90,91,92,103;58,47,36,37,38,49,60,71,72,83,94,95,106,107,108,109,120;69,70,59,48
12,0,15,9;61,49,37,25,26,27,28,29,30,42,54,66,78,90,102,114,113,112;69,81,93,105,117,129,141;75,63,51,39,40,41,53,65,77,89,101,100,99,111,123,124,125,126,127,115,103,91,79,67,55,43,31,19;143,142,130,118,106,94,82,70,58,57,45,33,34,35,23,11,10,9,8;46,47,59,71,83,95,107,119,131;122,121,109,97,85,73,74,62,50,38;5,4,3,2,1,0;22,21,20,32,44,56,68,80,92,104,116,128,140,139,138,137,136,135,134,133,132,120,108,96,84,72,60,48,36,24,12,13,14,15,16,17,18,6,7;110,98,86,87,88,76,64,52
11,0,16,6;93,94,95,96,85,74,63,52,41,30,29,28,27,26,15,14,13,12,23,34,45,56,67,78,89,100,111,110;99,88,77,66,55,44,33,22,11,0,1,2,3,4,5,16,17,18,19,20,31,42,53,64,75,86,97,108,107,106,105,104,103,92,81,82,83,72;25,36,37,38,39,40,51;60,59,58,57,68,79,90,101,112,113,114,115,116,117,118,119,120,109,98,87,76,65,54,43,32,21,10,9,8,7,6;24,35,46,47,48,49,50,61,62,73,84;71,70,69,80,91,102
10,0,17,6;54,55,65,75,85,95;25,26,27;82,81,71,61,51,41,31,21,11,12,13,14,15,16,17,18,28,38,48,58,68,78,79,89,99,98;62,72,73,83,93,92,91,90,80,70,60,50,40,30,20,10,0,1,2,3,4,5,6,7,8,9,19,29,39,49,59,69;88,87,77,67,57,47,37,36,35,34,24,23,22,32,42,52,53,63,64,74,84,94;97,96,86,76,66,56,46,45,44,43,33
11,0,18,8;106,107,108,97,98,87,76,65,54,43,32,21,10,9,8,7,6,5,4,15;12,13,14,25,26,27,16,17,18,19,20,31,42,53,64,75,86,85,96,95,94,105,116,117,118,119,120,109;92,81,70,71,72,61,62,51,40;28,29,30,41,52,63,74,73,84,83,82,93,104,103,102,101,100,89,78,67,56,45,46,47,48;49,60,59,58,57,68,79;90,91,80,69;50,39,38,37,36,35,34,33,44,55,66,77,88,99,110,111,112,113,114,115;3,2,1,0,11,22,23,24
12,0,19,8;39,40,28,29,30,31,32,33,34,35,23,11,10,9,8,7,6,5,4,3;77,78,66,54,55;79,91,90,89,88,76,75;87,99,100,101,102,103,104,92,80;22,21,20,19,18,17,16;15,27,26,38,50,51,52,53,41,42,43,44,45,46,47,59,71,83,95,107,119,131,143,142,141,140,139,138,137,136,135,134,133,132,120,108,96,84,72,60,48,36,24,12,0,1,2;65,64,63,62,74,86,98,110,111,112,113,114,115,116,117,105,93,81,69,68,67;14,13,25,37,49,61,73,85,97,109,121,122,123,124,125,126,127,128,129,130,118,106,94,82,70,58,57,56
11,0,20,7;47,46,45,56,67,78,89,100,101,102,103,104,105,106,107,108,97;84,83,82,81,80,69;51,50,49,48,37,36,35,34,23;0,1,2,3,14,15,16,17,18,19,20,31,42,53,64,75,86,85,96,95,94,93,92,91,90,79,68,57,58,59,60,61,62;40,39,38,27,26,25,24,13,12,11,22,33,44,55,66,77,88,99,110,111,112,113,114,115,116,117,118,119,120,109,98;28,29,30,41,52,63,74,73,72,71,70;87,76,65,54,43,32,21,10,9,8,7,6,5,4
10,0,21,8;4,3,2,1,0,10,20,30,40,50,60,70,80,90,91,92,93,94,95,96,97;89,79,69,59,49,39,29,19,9,8;76,75,74,73,72;99,98,88;67,66,65,64,63,62,52,42,32,22;46,36,35,25;56,57,47,37,27,26,16,15,14,24,34,44,45;5,6,7,17,18,28,38,48,58,68,78,77,87,86,85,84,83,82,81,71,61,51,41,31,21,11,12,13,23,33,43,53,54,55
11,0,22,7;10,21,20,31,42,53,64,75,74,73,72,71;77,88,99,110,111,112,113,114,115,116,117,118,119,120,109,98,97,96,95,94,93,92,91,80,69,58;28,17,6,5,4,3,2,1,0,11,22,33,44,55,66,67,78,89,100,101,102,103,104,105,106,107,108;36,47,46;90,79,68,57,56,45,34,23,12,13,14,15,16,27,38,39;35,24,25,26,37,48,49,50,51,40,29,18,7;32,43,54,65,76,87,86,85,84,83,82,81,70,59,60,61,62,63,52,41,30,19,8,9
12,0,23,7;104,103,102,101,100,99;27,15,16,17,18,19,20,21,22,34,46,58,70,82,94,93,92;118,130,129,128,127,126,125,113,112,111,110,98,86,87,88,89,90,91;114,115,116,117,105,106,107,119,131,143,142,141,140,139,138,137,136,135,134,133,132,120,108,96,84,72;124,123,122,121,109,97,85,73,74,75,76,77,78,79,67,68,56,44,43,42,41,53,52,51,50,49,37,25,13,1,0;55,54,66,65,64,63,62,61,60,48,36,24,12;80,81,69,57,45,33,32,31,30,29,28,40,39,38,26,14,2,3,4,5,6,7,8,9,10,11,23,35,47,59,71,83,95
11,0,24,6;24,25,26,27,28,29,30;50,51,52,53,54,43,32,21,10,9,8,7,6,5,4,3,2,1,0,11,22,33,44,45;48,49,60,61,62,63,64,65,76,87,98,109,120,119,118,117,116,115,114,113,112,111,110,99;23,12,13,14,15,16,17,18,19,20,31,42,41,40,39,38,37,36,47,58,59,70,71,72,73,74,75,86,97,108;34,35,46,57,68,69,80,81,82,83,84,85,96,107,106,105,104,103,102,101,100,89,88,77,66;55,56,67,78,79,90,91,92,93,94,95
10,0,25,6;65,64,63,53,43,33;79,89,99,98,97,96,95,94,93,92,91,90,80,70,60,50,40,30,20,10,0,1,2;77,67,57,47,37,27;69,59,49,39,29,19,9,8,7,6,5,15,25,35,45,46,56,66,76,75,74,73,72,62,52,42,32,22,23,13,3;12,11,21,31,41,51,61,71,81,82,83,84,85,86,87,88,78,68,58,48,38,28,18,17,16,26,36;4,14,24,34,44,54,55
11,0,26,7;70,59,58,47,36,37,38,39,50,61,62,73,84,83,94,105,116,115,114,113,112,111,110,99;57,46,35,24,25,26,27,28,29,40,51;48,49,60,71,72;30,41,52,63,74,85,96,95,106,117;92,91,90,79,78,77,66,55,44,33,22,11,0,1,2,3,4,5,6,7,8,9,10,21,32,43,54,65,76,87,98,109,120,119;118,107,108,97,86,75,64,53,42,31,20,19,18,17,16,15,14,13,12,23,34,45,56,67,68,69,80,81,82,93;88,89,100,101,102,103,104
12,0,27,7;90,102,103,104,105,93,81;44,43,42,41,40,39,38,50,62,74,86,98,110,111,112,100,88,76,64,65,66,67;143,142,141,140,139,138,137,136,135,134,133,132,120,108,96,84,72,60,48,36,24;79,78,77,89,101,113,114,126,127,128,129,130,131,119,107,95,83,71,59,47,35,23,11,10,9,8,7,6,5,4,3,2,1;125,124,123,122,121,109,97,85,73,61,49,37,25,26,27,28,29,30,31,32,33,45,57,69,68,80,92,91;0,12,13,14,15,16,17,18,19,20,21,22,34,46,58,70,82,94,106,118,117,116,115;56,55,54,53,52,51,63,75,87,99
11,0,28,6;22,23,24;88,77,66,55,44,33,34,35,36,25,26,27,28,29,30,41,52,51,50,61,72,71,70,69,80,91,102,113,114,115,116,117,118,119,120,109,98,87,76,65,54,43,32,21,10,9,8,7,6,5,4,3,2,1,0,11;86,97,108,107,106,105,104,103,92,81,82,83,84,73,62,63,64,53,42,31,20,19,18,17,16,15,14,13,12;40,39,38,49,60,59,58,57,68,79,90,101,112,111;110,99,100,89,78,67,56,45,46,47,48,37;75,74,85,96,95,94,93
10,0,29,6;27,26,36,35,34,33,43,42,52,62,72,82,92,93,94,95,96,97;59,69,68,67,66,65,55,54,53,63,73,83,84,85,86,87,88,98;44,45,46,56,57,58,48,49,39,29,19,9,8,7,6,5,4,3,2,1,0,10,20,30,40,50,60,70,80,90;47,37,38,28,18,17,16,15,14,13,12,11,21,31,41,51,61,71,81,91;25,24,23,22,32;99,89,79,78,77,76,75,74,64
11,0,30,5;59,48,37,26,27,16,17,18,19,20,31,42,53,64,75,86,97,108,119,118,117,116,115,114,113,112,111,110;120,109,98,87,76,65,54,43,32,21,10,9,8,7,6,5,4,15,14,25,36,47,58,69,70,71,60,49,38,39,40,51,62,73,84,95,94,93,92,91,90,89,78,67,56,45,34,23;1,2,3;28,29,30,41,52,63,74,85,96,107,106,105,104,103,102,101,100,99,88,77,66,55,44,33,22;0,11,12,13,24,35,46,57,68,79,80,81,82,83,72,61,50
